的	;
是	k
了	y
在	g
人	o
我	m
他	n
有	gv
中	j
来	b
上	i
大	d
为	u
到	h
会	ov
你	nv
以	z
子	yv
年	hh
就	s
得	dd
家	w
下	a
发	zv
好	hv
后	p
天	av
用	l
然	r
起	bv
没	v
现	c
前	uv
想	f
又	x
些	iv
见	lv
月	q
头	t
三	cv
外	rv
世	e
不	g;
这	w;
国	j;
个	o;
和	m;
们	n;
说	s;
地	d;
也	y;
要	f;
出	z;
着	u;
对	x;
可	a;
里	k;
去	b;
多	r;
成	h;
学	v;
同	l;
理	c;
所	p;
点	i;
问	t;
其	e;
几	q;
一	aa
时	kd
生	mc
过	wd
之	wa
么	mz
经	zx
日	ka
于	ad
心	wz
方	sy
面	gj
法	vb
全	oc
长	ch
当	kx
与	az
关	ug
十	ed
已	yy
情	uc
等	mb
话	sm
但	nk
使	na
女	zm
太	gs
制	ml
利	mk
名	rj
气	my
水	kv
教	by
入	od
打	da
济	vs
数	uz
常	kj
任	nm
万	ay
神	wi
改	ym
军	wh
边	wy
代	nh
爱	pw
思	kw
张	yc
品	jj
许	se
必	wm
组	zl
近	wp
完	wb
该	ss
司	ya
则	lk
际	yb
士	ba
示	bk
省	km
视	wl
罗	lr
标	fb
容	wo
跟	jx
英	el
音	sk
质	pe
争	rx
纪	zy
喜	bj
势	dq
协	ey
晚	kr
曾	ul
令	ow
送	wu
古	ej
赛	we
校	fs
微	ol
刻	sz
网	lo
医	hm
底	tr
律	ox
称	mr
策	mf
假	nx
细	zk
既	xh
普	uk
密	ww
爷	oo
劳	ew
预	xg
啊	jy
欧	ho
胜	qm
泽	vx
属	xm
靠	mj
温	vk
互	bz
贵	ji
暗	ks
控	dw
湖	ve
藏	eh
促	nj
异	ye
忘	sw
窗	wn
刊	ae
齐	sn
压	gb
审	wk
扬	dy
贫	oy
唱	jk
灯	ua
抱	dr
厅	ga
录	xk
付	nd
刀	yd
误	sj
敌	mm
授	dp
墙	be
避	wx
刺	fl
抽	dk
仁	nb
择	dx
描	de
乌	rz
键	py
抢	do
蓝	ek
狗	qr
沈	vw
夺	gd
乘	mt
启	wj
钢	pl
晨	kg
订	sa
吹	jr
惜	ue
愈	oa
贴	li
询	sr
忆	uy
柳	fr
舒	om
绕	zh
欣	pr
井	bn
漂	vf
伏	ng
芬	eo
斤	pd
偶	nz
垂	me
咬	js
狱	qs
幼	zz
聊	cr
账	lc
寸	ds
盯	la
胁	qy
耻	ci
妨	zs
猎	qe
辟	xj
煌	un
逸	wr
哎	je
匠	hp
蛮	si
咨	tj
睹	lb
烤	ub
动	bz;
美	ug;
记	sy;
便	na;
资	tr;
委	mz;
克	ej;
选	wm;
证	sa;
族	sm;
坚	kx;
考	ba;
游	vs;
够	rj;
演	vw;
富	wa;
宣	wb;
竟	sk;
简	mt;
监	km;
跑	jr;
祖	wl;
遇	wk;
迎	wr;
训	sn;
守	wd;
帝	sw;
卷	uy;
勒	ey;
欲	oo;
姆	zz;
婆	vx;
混	vk;
妙	zk;
厉	ga;
牧	mm;
躺	nk;
患	jj;
耐	gd;
赤	bn;
胞	qr;
苍	eo;
猫	qe;
铜	pl;
赌	lb;
窝	wj;
喷	je;
拆	dp;
撑	dk;
绣	zm;
妞	zx;
卉	ed
沓	kv
盂	ad
羹	uv
饵	oc
轼	hh
弭	yc
愆	ov
琊	ch
殛	ay
陬	yc
亍	aa
趸	ay
劢	ay
轾	hh
虿	ay
刂	kd
鹪	nv
匦	hh
菝	ed
鼗	rv
嵴	lv
劁	nv
磲	gv
墚	bv
镸	ch
長	ch
〢	kd
氺	kv
臸	hh
玭	ch
她	zyi
道	wun
那	yby
作	nmi
自	nla
行	oia
而	gla
小	koa
能	zqr
看	mdl
事	djx
民	yhd
开	aev
还	wgi
进	wbn
都	bmy
工	bia
业	kua
本	fav
实	wtg
主	scv
文	soa
部	sjy
分	oyd
把	dyi
新	sfp
定	wda
只	jov
样	fuc
两	foa
者	bma
从	ood
如	zmj
高	sja
种	mji
意	skw
力	yma
公	ozd
重	mkb
无	agr
手	mda
明	kqv
政	aim
报	dyx
知	maj
老	brr
市	sli
加	ymj
儿	rda
建	yxb
正	aii
展	xeh
回	jdj
因	jda
什	ned
合	oaj
此	irr
向	nlj
产	sum
将	trd
表	crh
间	tlk
二	bda
机	fqd
很	oxo
走	boa
西	fja
化	nrr
体	nfa
己	yya
身	nca
先	mrd
最	kcx
社	wsb
门	tla
声	bxm
并	uae
平	aua
总	ujw
特	mbd
信	nsv
系	mzv
给	zoj
相	flv
位	nsu
次	tro
应	tva
第	myz
场	byo
员	jlo
今	osx
电	kzv
提	dkv
由	kie
立	sua
设	sqx
真	elo
各	rsj
口	jaa
安	wzm
内	lod
务	rym
结	zbj
别	jyk
通	wxl
性	umc
活	vmi
斯	epd
处	rid
笑	mmg
比	hrr
目	laa
区	hos
度	tex
题	kgo
北	trr
书	xys
东	hko
少	kom
金	paa
再	alb
眼	lxo
解	rlm
统	zsr
才	dmv
被	wxi
四	lka
义	sos
做	nem
听	jpd
强	yji
放	smo
海	vmz
保	njf
科	mte
果	kfv
件	nmb
路	jrj
它	wrr
管	mwx
更	ako
山	lla
计	sed
华	nre
感	haw
基	ecb
马	xaa
住	nsc
尔	rka
决	txg
白	nka
及	yms
干	aed
程	mjc
农	wrh
党	kjr
元	brd
接	dsz
车	hea
据	dxj
光	kgr
受	pwx
原	gnk
象	rjg
亲	suf
夫	bod
交	soo
五	bix
量	kab
何	naj
难	xni
术	fsv
论	sor
觉	vwl
拉	dsu
领	owg
认	sod
办	ymo
期	ecq
色	ryi
步	iko
望	sqc
德	oew
风	qos
像	nrg
议	sso
至	hba
界	kon
求	dvs
却	bzy
物	mro
企	oii
京	sko
算	mle
技	dex
队	yod
南	eld
式	hbi
变	sxs
条	rsf
快	uxg
达	wgd
指	drk
直	elc
院	ywr
或	hja
战	ijh
形	aep
共	eao
非	kca
服	qyx
治	vzj
持	dbd
呢	jxr
取	cxs
候	nim
导	yds
收	zmo
字	wya
花	enr
清	vcq
带	ewl
深	vwf
王	caa
命	oay
调	slj
怎	miw
转	hbs
反	pxs
告	mbj
让	sia
联	cug
连	whe
集	nif
死	arr
流	vsn
叫	jzi
谈	suu
传	nbs
且	lca
每	mzy
往	osc
格	frj
言	saa
江	vbi
写	waa
规	bol
切	hyd
城	bhy
增	buk
府	tnd
运	wbz
息	nwz
房	wsy
图	jrt
李	fya
举	vab
识	sjo
广	tga
满	vef
局	xyj
革	eea
精	ucq
台	zdj
极	fys
志	bwz
团	jdm
似	nzo
众	ooo
友	gxs
远	wbr
亚	aku
吃	jmy
钱	phm
林	ffv
百	ank
布	gli
村	fds
单	uke
轻	hxb
语	sbj
即	xoy
研	gae
造	wmj
确	grl
观	xlr
青	ciq
空	wbi
育	szq
脸	qov
项	bgo
商	sld
吗	jxv
九	qya
首	unl
整	fji
根	fxo
吧	jyi
参	zgp
究	wqy
级	zys
支	exs
请	scq
师	kal
兴	vao
八	oaa
类	ugd
坐	oob
巴	yia
未	bko
约	zrs
影	ksp
权	fxs
群	xju
红	zbi
半	uba
始	zzj
专	bzs
失	mod
推	dni
准	tni
孩	yso
双	xxs
落	evj
早	ked
查	fka
乐	rko
客	wrj
费	ynl
站	sij
热	dqv
阿	yaj
功	bym
构	frz
引	yzi
找	dhm
消	vkq
乎	mua
模	feg
施	smy
云	bzd
具	lco
周	lbj
包	ryy
投	dqx
需	fgl
离	soz
节	eyv
紧	kxz
照	kyv
复	mkr
火	uoa
线	zhm
创	oyk
严	akm
倒	nhk
备	rki
石	gaa
易	kro
存	giy
片	nxa
效	som
历	gym
越	bhm
史	jos
讲	sbn
黑	lbv
职	cjo
母	zya
父	oos
香	mfk
断	zup
随	ywq
环	cgi
足	jia
尽	xst
艺	eyd
况	tjr
希	ogl
拿	oam
虽	jiv
若	egj
官	wxx
型	aeb
维	zni
愿	gnw
护	dwm
价	non
县	lzd
怕	unk
织	zjo
苦	eej
六	sov
续	zeg
责	clo
装	tbs
欢	xro
须	pgo
优	ngr
注	vsc
男	kym
答	moj
响	jnj
故	ejm
值	nel
七	hda
列	akd
句	ryj
树	fxd
副	ajk
衣	sra
病	tfo
段	ncq
境	bsr
千	mea
您	nrw
席	tel
念	osw
户	wma
显	kku
兰	ubd
武	ahi
采	pvf
留	rsk
乡	zzm
飞	ytd
河	vaj
谁	sni
案	wzf
突	wgs
低	nrs
益	uol
刚	lkd
奇	gaj
依	nsr
待	obd
态	gsw
较	hso
营	ewj
终	zrt
姐	zlc
器	jjj
积	mjo
黄	eko
除	yom
土	baa
央	lgd
划	hkd
诉	sps
致	hmo
供	neo
画	akz
访	ssy
哪	jyy
久	rsv
仅	nxs
夜	snr
破	gxi
助	lym
号	jaz
习	yta
初	wyd
阳	ykv
率	sve
冷	tow
州	vnd
继	zzu
负	rlo
层	xbz
闻	tce
尼	xrr
兵	pdo
木	faa
另	jym
读	seg
验	xov
批	dhr
米	ufa
娘	zsx
丽	all
害	wcj
绝	zry
港	vey
妈	zmx
源	vgk
春	coa
防	ysy
居	xej
诗	sbd
酒	vfd
惊	usk
静	cqx
哥	ajj
索	ewz
银	pxo
急	rxw
充	szr
料	ute
星	kmc
善	uuj
福	wak
块	bxg
范	evy
仍	nym
厂	gga
铁	pmo
穿	whi
围	jby
余	omf
察	wrb
养	und
章	ske
抓	dpv
速	wfj
朋	qqv
敢	xcm
帮	cml
获	eqs
修	nip
按	dwz
检	fov
船	pqj
素	ciz
龙	gma
亿	nyd
陈	yhk
止	iia
朝	eeq
排	dkc
斗	ted
球	cds
印	ray
错	pek
妇	zxb
版	npx
派	vpr
脚	qby
忙	ush
汉	vxs
般	pqx
伤	nmy
独	qmi
评	sau
景	ksk
序	txx
执	dqs
弟	uyz
剧	xek
承	xkc
试	shb
良	sxo
买	xtg
馆	owx
甚	ecz
屋	xhb
卡	iai
换	drg
饭	opx
警	ers
困	jdf
岁	lrs
刘	skd
室	whb
楼	fuz
座	tob
讯	sye
波	vxi
财	ldm
险	yov
谢	snd
玉	csv
停	nsa
差	ubi
姑	zej
宝	wcs
乱	miz
沉	vwq
镇	peo
永	wva
痛	txl
击	bzi
角	rld
洲	vvn
例	nak
杀	osf
雨	fva
苏	eyo
限	yxo
哈	joj
食	oxa
顾	gyg
毛	mha
烈	akv
适	wmi
配	fyy
某	ebf
担	dka
词	syj
讨	sds
草	eke
置	lel
堂	kjb
园	jbr
礼	wsz
怪	uxb
款	bbr
顿	hzg
亮	swq
编	zwl
忽	row
库	the
慢	ukx
沙	vkm
略	krj
激	vnm
否	gij
脑	qsz
献	els
怀	ugi
班	cuc
招	dyj
呼	jmu
阵	yhe
睛	lcq
胡	ejq
份	noy
背	trq
威	haz
冲	tji
伯	nnk
嘴	jil
纳	zlo
歌	ajr
状	tgs
占	idj
稳	mrw
血	mlk
域	bha
田	kia
皮	xia
油	vki
奥	nug
述	wfs
托	dmh
贸	rsl
伊	nxb
旧	ikv
钟	pji
笔	mmh
露	fjj
挥	dwh
街	obb
药	ezs
午	med
卫	yav
呀	jhi
顺	ngo
罪	lkc
灵	xuo
睡	lmb
雷	fki
秋	muo
荣	ewf
旁	sws
莫	ekg
戏	xhm
味	jbk
喝	jkr
健	nyb
赶	bae
销	pkq
洋	vuc
短	mau
肯	iiq
础	gzz
渐	vhp
散	eqm
疑	rmi
税	mur
股	qqx
均	brt
舞	meh
旅	smr
左	gbi
阶	yon
篇	mwl
秀	mym
烟	ujd
掉	die
届	xki
束	fjv
免	rjr
康	txk
努	zxy
恶	akw
救	dvm
归	kxb
卖	exg
著	ebm
佛	nyn
杂	qyf
超	byj
店	tij
罢	lbz
板	fpx
退	wxo
犯	qyy
介	ond
跳	jrv
临	kmk
俄	nms
征	oai
幸	bub
牌	nne
抗	dsq
庆	tgd
概	fxh
婚	zrk
摇	dpl
玩	cbr
坏	bgi
梅	fmz
吉	bjv
追	wmx
宁	wai
耳	cea
梦	ffr
尚	kld
曲	kkd
判	ukd
培	bsj
雪	fxb
右	gdj
纸	zrh
松	foz
货	nrl
减	thj
丝	zza
脱	qur
妹	zbk
杨	fyo
楚	ffi
庭	tyb
朱	mko
封	bbd
端	slg
降	yrh
剑	obk
输	hok
赵	bos
吴	jag
登	xou
络	zrj
默	lbs
伟	nby
兄	jrd
顶	ago
孙	yko
床	tgf
瑞	clg
套	gch
移	mrr
掌	kjm
探	dwf
软	hro
危	rgy
绿	zxk
绍	zyj
叶	jed
材	fdm
博	efd
练	zho
票	fbk
针	ped
督	ial
弄	cev
伙	nuo
奖	trg
咱	jnl
私	mzd
恐	bqw
吸	jys
鼓	bjx
娜	zyy
核	fso
鲁	rkv
翻	pky
野	kbx
塔	bej
唐	txj
君	xbj
融	aji
缺	mlg
扩	dtg
圣	xsb
夏	anr
秘	mwm
测	vlk
轮	hor
额	wrg
塞	web
丰	cia
彩	pfp
牛	mba
谓	skq
洛	vrj
阴	yqv
升	mev
曰	kaa
桌	ikf
措	dek
寻	xds
含	osj
巨	hxv
奶	zym
竞	sjr
庄	tgb
鲜	ruc
仿	nsy
禁	ffb
贝	loa
败	lmo
恩	jwz
盘	plk
逐	wgq
操	djf
替	bok
赞	mrl
蒙	ewg
盖	ulk
补	wid
诺	sej
握	dxh
奋	gki
枪	foy
童	skb
搞	dsj
借	nek
架	yjf
页	goa
智	mjk
菜	epf
杰	fvv
汽	vmy
珠	cmk
燕	etv
茶	eof
洪	veo
毫	swm
哭	jjs
括	dmi
肉	loo
闹	tsl
瓦	azs
泪	vlv
毒	czy
醒	fkm
映	klg
固	jej
啦	jds
雄	gzn
妻	axz
粮	usx
射	nds
典	leo
邓	xsy
鬼	nja
忍	ysw
摆	dlz
丁	aia
凡	qds
趣	bcx
熟	syv
曼	klx
予	xxa
盟	kql
遍	wwl
晓	khg
灾	wuo
杯	fgi
岸	lge
虑	iwz
姓	zmc
萨	eym
尊	ufd
析	fpd
勇	xly
拥	dld
毕	hre
伸	nki
敬	erm
雅	hni
伦	nor
尤	gra
休	nfv
丈	aos
悲	kwz
幕	ekl
攻	bmo
莱	ebk
亦	sno
澳	vng
盛	hyl
售	nij
迷	wuf
湾	vsy
爸	ooy
购	lrz
弹	yue
岛	rll
挂	dbb
闪	tod
怒	zxw
坦	bka
损	djl
硬	gao
埃	bzm
虚	iku
诚	shy
陆	ybz
逃	wrv
森	fff
麻	tff
鱼	raa
爵	pld
缓	zpx
淡	vuu
喊	jhj
凤	qxs
冰	tkv
宫	wjj
隐	yrw
宗	wbk
弱	ytt
骨	lwa
懂	ueb
附	ynd
透	wmm
召	ydj
牙	hia
汇	vhv
码	gxv
纷	zoy
乔	mgn
徐	oom
宽	wel
遗	wjl
驻	xsc
载	ehh
蒂	esl
洗	vmr
释	pxb
桥	fmn
拜	mac
签	mov
航	psq
迅	wye
迹	wso
课	skf
拍	dnk
泰	ckv
浪	vsx
川	nda
扶	dbo
译	sxb
恨	uxo
彻	ohy
幅	lak
皇	nkc
途	wom
残	ahm
岗	lld
障	yse
厚	gky
佩	nql
圆	jjl
折	dpd
符	mnd
丹	qsv
玛	cxv
旗	sme
贯	zel
韩	eby
叹	jxs
瞧	lnv
闭	tdm
违	wby
孔	yaz
津	vxb
亡	sha
忠	jiw
柔	xmf
祝	wjr
寒	wet
偏	nwl
繁	mzz
烦	ugo
杜	fbv
伍	nbx
季	mya
享	sya
怜	uow
延	ymi
迫	wnk
播	dpk
狂	qmc
徒	obo
眉	xml
烧	uhg
劲	xby
舍	omi
聚	cxg
挑	drv
戴	eho
闲	tlf
虎	iqd
申	kid
巧	baz
累	kiz
肩	wmq
沿	vqj
唯	jni
振	dgh
抵	drs
朗	sxq
抬	dzj
偷	nok
绩	zcl
洞	vld
扎	dzv
伴	nub
震	fgh
乃	ymv
袋	nhs
诸	sbm
佳	nbb
摸	deg
署	lbm
径	oxb
昨	kmi
珍	cop
奔	gee
冬	rtd
潮	veq
筑	mbs
芳	esy
摄	dcx
麦	crs
综	zwb
迪	wki
穷	wym
泛	vmw
琴	ccx
鹏	qqr
辑	hjc
呆	jfv
彼	oxi
仪	nso
纯	zhz
宜	wlc
猛	qyl
冒	klv
谋	sef
腿	qwx
践	jhm
赏	kjl
邦	cmy
灰	guo
染	vqf
胸	qrz
骂	jjx
末	afv
餐	iro
壮	tib
迟	wxs
碰	guk
糊	ueq
惯	uzl
辛	sea
涉	vik
横	feo
辈	khe
胆	qka
弃	sze
峰	lrc
宋	wdf
贡	blo
氏	rha
谷	ooj
仙	nll
疗	tyv
洁	vbj
缩	zwn
尖	kgd
贷	nhl
壁	xjb
遭	wek
朵	qdf
币	mli
铺	pfb
植	fel
番	pki
隔	yal
灭	auo
冠	wbd
梁	vyf
叔	iax
兼	uxk
辆	hfo
艰	xxo
暴	kek
陪	ysj
触	rli
弗	ynd
俗	noj
凯	lyq
污	vbz
忧	ugr
缘	zzg
郎	sxy
净	trx
悉	pwz
辞	mse
荒	esn
勤	ejy
恢	ugu
疾	tma
债	ncl
奉	cbi
辉	kgh
励	gay
黎	mrk
郑	ugy
堆	bni
甲	kic
坡	bxi
骑	xgj
慰	xbw
艾	eos
莉	emk
储	nsb
零	fow
圈	juy
鸡	xrz
宏	wgz
犹	qgr
惠	fwz
卢	ixm
宾	wpo
貌	pnr
孤	yps
距	jhx
悄	ukq
镜	psr
菲	ekc
墨	lbb
椅	fgj
魂	bzn
裁	ehs
鸟	rza
锦	pnl
粗	ulc
凭	nmq
凉	tsk
薄	evd
秦	cmf
腰	qfz
晴	kcq
摩	tfm
誉	vas
赫	bno
羊	uca
筹	mcd
亏	bdz
枝	fex
箱	mfl
竹	mii
倾	nhg
跃	jmg
亩	ski
稍	mkq
邀	wnm
敏	mzm
插	dmn
颜	smg
递	wuy
函	xkz
荡	evo
刑	aek
凝	tri
矿	gtg
泥	vxr
皆	hrn
寄	wgj
旦	kav
慧	ccw
厌	ggs
跨	jgz
孟	ylk
祥	wuc
邮	kiy
览	kml
隆	yrm
拒	dhx
吓	jai
鼻	nkn
肃	xno
扫	dxb
殊	amk
董	emb
丢	mbz
臣	haa
翠	yye
腐	tno
倍	nsj
赖	fjl
援	dpx
粉	uoy
漫	vkx
盾	pel
豪	swg
臂	xjq
罚	lsk
昌	kkv
恰	uoj
侧	nlk
汗	vae
碎	gse
桑	xxf
邻	owy
纵	zoo
仆	nid
磨	tfg
阔	tvm
俩	nfo
匆	ros
廉	tux
骗	xwl
挺	dyb
阻	ylc
贺	yjl
毁	nbq
拖	dmy
仰	nry
拔	dgs
鞋	ebb
恋	swz
妮	zxr
匹	hrd
昏	rhk
魔	tfn
甘	eba
炸	umi
帽	lkl
挤	dsn
劝	xym
废	tzs
暂	hpk
勃	ewy
莎	evm
吨	jhz
侵	nxx
乏	mwv
棉	fnl
唇	ghj
趋	brx
浮	vpy
陶	yrl
肥	qyi
吕	jjv
拓	dgv
矛	xxm
滚	vsz
愤	uel
剩	mtk
哀	srj
吾	bxj
扑	did
搬	dpq
媒	zef
陷	yrn
猜	qcq
耶	cey
嫂	znx
莲	ewh
租	mlc
暖	kpx
疯	tqo
迈	way
吻	jro
稿	msj
飘	fbo
堡	njb
蛋	xii
渡	vtx
颇	xgo
煤	uef
棋	fec
返	wpx
帕	lnk
衡	org
仲	nji
饰	oml
吐	jbv
寂	wix
浓	vwr
宇	wad
润	vtc
荷	enj
截	ehn
频	ikg
潜	vbk
腾	qux
饮	oro
醉	fse
凌	tbr
紫	irz
泉	nkv
仇	nqy
尾	xmh
绪	zbm
幽	zzl
淑	vix
丧	euh
帐	lch
阁	trj
鸣	jrz
捐	djq
狠	qxo
炮	ury
愁	muw
嘉	bjj
旋	smi
尝	kbz
唤	jrg
怨	ryw
牢	wmb
涌	vxl
摘	dsl
尺	xms
躲	nqf
爬	pyi
逼	wak
锁	pkl
汤	vyo
辩	sss
呵	jaj
允	zrd
龄	iow
惨	uzp
岂	lyy
俊	nzr
巡	wzz
寿	cmd
颗	kfg
鉴	kmp
姊	zmm
详	suc
闷	twz
爆	ukk
聪	cuw
估	nej
嫁	zwg
擦	dwb
崇	lwb
袭	gsr
矣	zma
拳	umd
敦	sym
瓶	ues
拟	dzo
屈	xzz
扭	dxe
捕	dfb
撒	dem
坛	bbz
锋	prc
赴	bid
券	uyd
弯	syz
扣	djv
裂	aks
循	opl
抖	dte
踏	jkk
籍	mck
戈	hma
丛	ooa
幻	zzy
奏	cag
沃	vmg
焦	niv
牲	mmc
夹	buo
册	qqa
迁	wme
慌	uen
邪	hiy
谊	swl
埋	bkb
斜	ome
哼	jsy
哲	dpj
郭	syy
欠	roa
梯	fuy
烂	uub
虫	iaa
涂	vom
拼	due
掩	dgz
尘	kob
桂	fbb
偿	nkz
俱	nlo
敲	six
抚	dag
昂	kry
韦	biy
撞	dsb
搭	dej
宪	wmr
凶	ozi
慕	eku
盗	trl
霍	fni
纽	zxe
奴	zxs
傲	ncm
滑	vlw
涛	vcd
穆	mnp
仔	nya
恼	usz
添	vau
贾	flo
瓜	psa
哦	jms
柱	fsc
池	vyi
甫	fba
侯	nxm
奈	gbk
燃	urv
吟	jox
挣	drx
割	wck
肚	qbv
惑	hjw
曹	ekk
颤	sjg
钻	pij
拾	doj
扰	dgr
纠	zzi
皱	rxx
踪	jwb
瘦	tnx
炉	uwm
鸿	vbr
牵	gwm
悔	umz
搜	dnx
傅	nfd
宿	wnn
辽	wyv
浩	vmj
栏	fub
逻	wlr
玻	cxi
漠	veg
宅	wmh
揭	dkr
尸	xma
欺	ero
峡	lbu
甜	meb
姨	zgy
戒	hme
伐	nhm
碗	gwy
碍	gkd
卿	rmy
昆	khr
串	jji
庙	tki
沟	vrz
冯	tdx
羞	uxe
翼	yyo
袖	wki
溜	vrk
阅	tur
嘛	jtf
卧	hid
浙	vdp
耕	cbn
堪	bez
猪	qbm
丑	xed
档	fkx
辱	gds
拨	dzs
矩	mhx
琳	cff
疆	ybk
璃	csz
亭	swa
衫	wpd
霞	fxx
撤	dsm
湿	vkk
浅	vhm
脏	qtb
挨	dzm
役	oqx
慈	uzw
驱	xho
址	bii
姿	trz
扯	dii
赢	sjs
遵	wud
傻	nnr
桃	frv
叙	omx
娃	zbb
廷	ymb
廊	tsy
厨	gad
胖	qub
炼	uho
岳	pll
柜	fhx
覆	for
贤	kxl
郁	gqy
柏	fnk
驾	yjx
绘	zoz
萧	exo
扮	doy
捉	dji
悦	uur
呈	jcv
缝	zwc
睁	lrx
寺	bds
旨	rrk
侍	nbd
陵	ybr
殿	xeq
劣	kmy
嫌	zux
雾	fry
愉	uok
旺	kcv
饱	ory
扇	wyy
疲	txi
跌	jmo
惧	ulo
挖	dwy
械	fhe
岩	llg
屏	xue
糟	uek
仗	nao
轰	hxx
舅	nky
兹	uzz
爹	oor
妥	pzm
豆	aju
捷	dai
赠	luk
秩	mmo
伪	nus
雕	lbn
耀	kgn
驶	xjo
吞	agj
箭	muk
苗	eki
疼	trt
倡	nkk
膀	qss
慎	ueo
孝	bya
涨	vyc
牺	mfj
翁	ozy
遥	wpl
娇	zmn
嚷	jse
酸	fzr
篮	mkl
轨	hqy
逢	wrc
钦	pro
朴	fid
链	pwh
勉	rjy
滨	vwo
浑	vwh
汪	vcv
夕	rsa
歇	krr
饿	oms
羽	yyt
倘	nkl
墓	ekb
晃	kkg
滴	vsl
贼	lhg
疏	xin
披	dxi
吵	jkm
摊	dxn
稀	mol
恭	eou
茫	evs
吁	jad
滋	vuz
抛	dqy
盼	loy
氛	moy
绳	zjz
玄	szz
宴	wkz
艳	cry
剪	uqy
裕	woj
盈	yml
悟	ubj
卜	ida
韵	skt
刷	xlk
堤	bkv
塑	uzb
笼	mgm
毅	sgq
悬	lzw
灌	ven
熊	zqv
谅	ssk
柴	irf
畅	kyo
诱	smm
吊	jli
悠	niw
贪	osl
葡	erf
御	omy
诞	syi
裤	wth
铃	pow
忌	ywz
逝	wdp
瞪	lxu
渴	vkr
遂	wug
卓	ike
渠	vhf
殖	ael
柯	faj
舌	mia
盆	oyl
潘	vpk
蓄	esk
脉	qwv
扔	dym
溪	vpg
誓	dps
履	xor
脆	qry
懒	ufl
凑	tcg
框	fhc
戚	hik
愚	klw
徽	olm
蛇	iwr
瑟	ccm
杭	fsq
抹	daf
姚	zrv
庞	tgm
晋	akk
枚	fmo
巾	lia
唉	jzm
劫	bzy
葛	ekr
惟	uni
翰	eoy
赋	lai
脾	qne
捧	dcb
炎	uuo
圳	bnd
糖	utj
挡	dkx
症	tai
彭	bjp
昭	kyj
夸	gbz
缠	ztb
喂	jkh
袁	bjr
轿	hmn
弥	yrk
臭	ngs
腊	qek
侨	nmn
痕	txo
狼	qsx
衰	srk
碧	cng
谨	sec
酷	fmj
霸	feq
袍	wry
慨	uxh
哩	jkb
诊	sop
拦	dub
泼	vzs
厦	gar
咐	jnd
赔	lsj
押	dki
乙	yda
愧	unj
祸	wjo
耗	cmh
渔	vrv
纹	zso
蓬	ewc
尉	xbd
抑	dry
勾	rzd
锐	pur
畜	szk
洒	vfj
遮	wtv
秒	mkm
催	nln
脖	qey
侠	nbu
魏	mzn
盲	shl
耸	ooc
僧	nuk
聘	ckz
娶	cxz
仓	oyy
惩	oaw
碑	gne
蜜	wwi
齿	ioa
焉	aiv
妖	zmg
寓	wkz
挽	drr
婉	zwy
腔	qwb
矮	mmz
漏	vxf
惹	egw
滩	vxn
丘	pda
兽	ukj
盒	oal
寨	wef
衷	sji
削	kqk
怖	ugl
茨	etr
顽	brg
虹	ibi
倦	nuy
荪	eyk
岭	low
喘	jlg
葬	eae
肤	qbo
鞭	eno
腹	qmr
赐	lko
崔	lni
谦	sux
芒	esh
罩	lie
菊	eru
贞	ilo
豫	xrg
颁	oyg
姜	uzm
痴	tmj
骄	xmn
填	beo
屠	xbm
杆	fae
掏	drl
骤	xcg
狄	quo
旱	kae
陕	ybu
跪	jry
讶	shi
液	vsr
舟	pya
芝	ewv
裙	wxj
卑	nme
畏	kih
郊	soy
肠	qyo
玲	cow
泳	vwv
奸	zae
钧	prt
闯	tlx
膝	qfk
竭	skr
锡	pko
辰	gha
鼠	nzz
肖	koq
咖	jyj
剂	snk
衬	wds
谎	sen
萄	erl
啡	jkc
辨	sus
辅	hfb
咽	jjd
挪	dyy
歉	uxr
叉	xss
恒	ubk
鹰	tnr
歪	gai
舆	nbo
嘲	jeq
嗯	jjw
琛	cwf
棚	fqq
穴	woa
棵	fkf
遣	wjx
驰	xyi
凄	taz
晶	kkk
湘	vfl
蕾	efk
缴	znm
嫩	zfm
涵	vxz
爽	goo
纲	zld
昔	eak
浦	vfb
剥	xkk
兆	rdv
锅	pjo
渊	vnu
姻	zjd
钉	pai
殷	pxq
贩	lpx
纱	zkm
饼	oue
搁	dtj
稻	mpn
绸	zlj
泄	vez
逆	wuz
乳	pyz
契	cyg
黛	nhv
媳	znw
漆	vfk
雇	wni
枯	fej
泡	vry
盐	bil
蠢	cii
帘	wli
筋	mqy
绅	zki
巷	eoy
蒋	etd
讽	sqo
蔡	erb
颈	xbg
叠	xxl
堵	bbm
绵	znl
掘	dxz
趁	bop
摔	dse
鹤	wnr
媚	zxl
晤	kbj
纺	zsy
寡	wgy
搏	dfd
歧	iex
侦	nil
辖	hwj
掠	dsk
胳	qrj
拐	djy
烛	uoi
窃	why
冻	thk
祭	rxb
酬	fvn
茂	ehm
趟	bkl
攀	fom
喉	jnm
喃	jel
恳	xwz
眠	lyh
浴	voj
旬	ryk
粒	usu
丫	udi
巩	bqs
拘	drj
赚	lux
纤	zme
琼	csk
泊	vnk
娱	zjg
娅	zak
薇	eom
棒	fcb
祷	wcd
坟	bso
嘻	jbj
携	dnm
噢	jng
榜	fss
吼	jyz
桶	fxl
踢	jko
颊	bug
淮	vni
陌	yan
峻	lzr
斋	sgl
岚	lqo
柬	flk
霜	ffl
晕	kwh
逊	wyk
抄	dkm
蔬	exn
斥	pds
冤	wrs
梳	fsn
哟	jzs
寞	weg
嘿	jlv
帜	ljo
膊	qfd
饶	ohg
炭	lgu
怔	uai
吩	joy
哄	jeo
筒	mld
佐	ngb
哑	jak
帅	kli
胀	qch
壶	bwk
鲍	rry
捏	dkb
裹	skf
刹	ofk
栽	ehf
钩	prz
笨	mfa
辣	sfj
枕	fwr
僵	nck
嗓	jxf
藤	eqk
棍	fkr
瞬	lph
稽	mgk
谱	suk
耍	gzm
株	fmk
泣	vsu
裳	kjs
厢	gfl
珊	cqa
刮	mkd
坊	bsy
儒	nfg
磁	guz
砍	gro
祈	wpd
隶	xkv
乖	mtr
茅	exm
叛	upx
砖	gbs
躯	nho
瞒	lef
俯	ntd
咒	jjq
驳	xoo
蹈	jpn
栗	fjf
汝	vzm
焰	urn
骚	xxi
谣	spl
嘱	jxl
灿	ull
庸	txq
疫	tqx
宰	wse
厄	gyy
篷	mwc
绒	zhg
咳	jso
桐	fld
滥	vkl
瑰	cnj
钥	pqv
琪	cec
憾	uhw
斌	sai
罕	woe
舰	plr
薛	ems
颠	elg
颂	ozg
桩	ftb
弦	ysz
婴	llz
瞎	lwj
躬	nyz
狭	qbu
怯	ubz
彰	skp
圾	bys
垃	bsu
舱	poy
咕	jej
饥	oqd
玫	cmo
鸭	krz
斑	csc
颖	rmg
敞	klm
淋	vff
坑	bsq
掀	dpr
萝	elr
硕	ggo
宙	wki
鹿	txr
囊	ejr
懈	urm
衔	oip
溢	vul
狐	qps
窄	wmi
邹	rxy
乾	emy
桢	fil
蝶	ief
淘	vrl
狮	qkl
蜂	irc
弘	yzd
沾	vij
妒	zwm
妆	tzm
雀	kni
胶	qso
竖	kxs
坎	bro
滞	vel
铭	prj
魅	nbk
浸	vxx
暑	kbm
惶	unc
躁	jjf
肿	qji
糕	uuv
侮	nmz
崖	lgb
逗	wau
凳	xoq
鄙	jey
晰	kfp
胎	qzj
肌	qqd
顷	hgo
贱	lhm
倚	ngj
衍	oiv
罐	mln
匙	krr
塘	btj
呜	jrz
瞥	kll
荐	egy
帆	lqs
阐	tue
萍	evu
柄	ffo
侄	nhb
裸	wkf
哨	jkq
妄	szm
歹	ara
淫	vpb
拚	dze
喻	jok
匪	hkc
薪	esp
秃	mqd
恕	zjw
艇	pyb
屡	xuz
删	qqk
翔	uyy
绑	zcy
蹲	jud
谭	sfe
眨	lmw
佑	ngj
妓	zex
兑	ujr
芙	ebo
巫	boo
撕	dep
孕	ymy
陀	ywr
屁	xhr
毯	muu
胃	kiq
劈	xjy
壳	bwq
肝	qae
冈	lda
眸	lzm
夷	gyz
鸦	hrz
贿	lgq
亨	sjy
荆	eak
诵	sxl
勋	jly
粹	use
杖	fao
魄	nnj
钓	prs
尹	xba
腕	qwy
兮	oaz
彬	ffp
搂	duz
棺	fwx
嵌	ler
脊	voq
佣	nld
拱	deo
荫	eyq
苹	eau
啸	jxo
傍	nss
哉	ehj
涅	vkb
譬	xjs
翅	exy
禅	wue
乞	myd
肆	cxb
笛	mki
辜	ejs
栋	fhk
喀	jwj
哇	jbb
撰	dyo
蜡	iek
煞	rxv
宛	wry
弊	kle
仑	orr
奠	ufg
谐	shn
鹅	mzr
俏	nkq
姬	zmh
鼎	lzx
羡	utr
芦	ewm
拂	dyn
晒	kfj
诈	smi
兔	rjs
蕴	ezl
耽	cwr
猴	qnm
镕	pwj
驼	xwr
坠	yob
朽	faz
弓	yza
吏	ajo
艘	pnx
彦	smp
悼	uie
祁	wsy
憎	uuk
涯	vgb
斩	hpd
焕	urg
聂	cxx
钞	pkm
脂	qrk
瓷	trs
腻	qhl
逮	wxk
坝	blo
伺	nyj
壤	bse
雁	gnn
陋	yzf
幢	lsb
蔽	ekm
沫	vaf
骆	xrj
锻	pnq
茵	ejd
掷	duy
塌	bky
拢	dgm
喧	jwk
垒	zzb
樊	fog
兜	rnr
甸	rki
晌	knj
垫	dqb
夭	mgd
坪	bau
汛	vye
迭	wmo
碌	gxk
恍	ukg
癌	tjl
暮	ekk
盏	hlk
啤	jne
膨	qbp
剖	sjk
昧	kbk
肺	qal
寇	wbx
轩	hae
饲	oyj
蔑	els
乒	pdm
冶	tzj
逛	wqc
囚	jod
膜	qeg
屑	xkq
袜	waf
樱	flz
矢	maa
骇	xso
宠	wgm
挫	dob
擅	dsa
缎	znq
澡	vjf
汁	ved
畔	kub
敷	fsm
堕	ygb
叮	jai
鞠	eru
蕙	efw
愣	uls
粘	uij
哗	jne
揉	dxf
杏	fjv
淹	vgz
魁	nte
爪	pva
驴	xwm
卒	soe
洽	voj
犬	gds
烁	urk
僻	nxs
甩	qzv
禄	wxk
踩	jpf
卸	miy
稚	mni
埔	bfb
捞	dey
阎	trn
廓	tsy
沧	voy
肢	qex
砸	ghl
缚	zfd
嫉	ztm
啼	jsl
勿	rod
磋	gub
鸽	oar
惭	uhp
挚	dqm
勘	ezy
咸	haj
邱	pdy
俞	oak
伞	oua
邵	yjy
讼	soz
郡	xjy
蓉	ewj
煮	bmv
缅	zgb
渗	vzp
陡	ybo
捆	djf
缔	zsl
簇	msm
禽	osz
搅	dvl
梨	mkf
滔	vpn
襟	wfb
刃	yds
枉	fcv
麟	txh
凛	tsb
苟	erj
绮	zgj
姥	zbr
蒸	exv
锣	plr
瑶	cpl
枣	flt
咧	jak
霉	fmz
诧	swh
啥	jom
踱	jtx
靖	scq
澄	vxu
衙	obj
妃	zyy
遏	wkr
尿	xkv
莹	ews
熙	hyv
铸	pcd
龚	geo
馨	bxk
奎	gbb
揽	dkl
潭	vfe
菌	ejm
崩	lqq
捡	dov
叨	jyd
酿	fsx
睦	lbb
榻	fky
楣	fxl
隙	ykk
俭	nov
焚	ffu
愕	ujz
奢	gbm
丸	qys
浆	trk
婶	zwk
鞍	ewz
瞩	lxl
磕	gbl
熬	cyv
浇	vhg
裴	ksr
捣	drl
嚼	jpd
铅	pqj
窟	wxz
逾	wok
喇	jfk
詹	rgs
迄	wmy
楞	fls
炒	ukm
佟	nrt
斐	kso
帖	lij
噪	jjf
棠	kjf
贬	lmw
摧	dln
莽	ege
妾	szm
蹄	jsl
窘	wxj
眷	ubl
枫	fqo
坤	bki
扁	wld
匀	rtd
耿	cuo
呐	jlo
谴	swx
呻	jki
丐	aiz
栈	fhm
斧	oop
汰	vgs
阀	tnh
撇	dkm
暇	kxx
呕	jho
茜	efj
氧	muc
狡	qso
菱	ebr
痒	tuc
昼	xsa
溃	vjl
辫	szs
窥	wbl
缕	zuz
缀	zxx
簿	mvd
冀	tro
烫	vyu
靴	enr
慷	utk
廖	typ
琐	ckl
旭	qyk
俘	npy
膛	qkb
瞻	lrs
敛	obm
璇	csi
豹	prs
郝	bny
窜	wji
绞	zso
阮	ybr
旷	ktg
蚀	oxi
忖	uds
涩	vyi
婿	zxq
崭	lhp
诡	sry
蒲	evf
膏	swq
橱	fgd
虐	iha
磊	ggg
葱	erw
灼	urs
沸	vyn
巢	zzf
镶	pse
嗽	jfr
镖	pfb
冥	wko
诃	saj
乓	pds
梢	fkq
抒	dxx
发	zms
娥	zms
蔓	ekx
琦	cgj
嘟	jby
渺	vlm
蓓	enj
倩	ncq
沛	val
烘	ueo
莺	ewr
讥	sqd
棕	fwb
藻	evf
陛	yhb
碟	gef
凸	iaa
侣	njj
俺	ngz
朦	qeg
圭	bbv
拣	dho
咯	jrj
颓	mqg
槐	fnj
拙	dzz
熄	unw
斟	eze
咙	jgm
虞	ijg
禹	mil
绷	zqq
黯	lbk
沪	vwm
擒	doz
帧	lil
芽	ehi
嗡	joy
芭	eyi
倏	nis
湛	vez
橡	frg
胧	qgm
瞄	lek
乍	mid
谬	syp
嘶	jep
缆	zkl
毙	hrr
翩	wly
潇	veo
吱	jex
叩	jyv
栅	fqa
钮	pxe
绢	zjq
尧	hgr
丙	foa
屯	hzi
婢	zne
轴	hki
蛙	ibb
悯	uts
浏	vsk
缸	mlb
杉	fpd
寝	wtx
叭	jov
菩	esj
僚	ngk
蝇	ijz
襄	sje
庚	txo
孽	emy
徊	ojj
匣	hki
灶	uob
梭	fzr
嘎	jah
垦	xob
澜	vtl
熏	mlv
绰	zie
虔	iso
冉	ldb
咏	jwv
镑	pss
酱	trf
筝	mrx
讳	sby
厕	glk
札	fzv
伶	now
宵	wkq
藉	eck
闺	tbb
帷	lni
兢	ejr
蓦	ekx
牡	mbb
厮	gep
撼	dhw
擎	erm
觅	plr
芸	ebz
檐	frs
炳	ufo
褂	wbi
筷	mug
挟	dbu
眯	luf
霓	fnr
瘫	txn
缪	zyp
橘	fxl
瞅	lmu
揣	dlg
尴	gkl
虾	iai
尬	gon
墅	kbb
聋	gce
巍	lmn
袱	wns
禀	sjb
苔	ezj
牟	zmb
徘	okc
絮	zjz
茄	eyj
珀	cnk
庵	tgz
募	eky
砂	gkm
霖	fff
搀	drt
窑	wml
龟	rkz
啪	jdn
虏	iym
咪	juf
螺	ikz
匈	roz
跋	jgs
嗦	jez
苑	ery
燥	ujf
岔	oyl
寥	wyp
扛	dbi
庐	twm
谜	swu
缉	zjc
蚁	iso
砰	gau
醋	fek
赁	nml
秉	mxb
辐	hak
嗳	jpx
揪	dmu
蔚	exd
酋	ufd
溅	vlh
厘	gkb
肘	qds
惘	uld
唔	jbj
暨	xha
琢	cgs
秽	mlr
珂	caj
汹	voz
霄	fkq
萌	ekq
瑜	cok
璐	cjj
嗅	jns
怡	uzj
蜀	lri
戳	yyh
眶	lhc
蝴	ieq
嘘	jik
杠	fbi
娴	ztf
枢	fho
忿	oyw
孜	ymo
稼	mwg
萎	emz
卵	rss
茱	emk
蝎	ikr
髦	cpm
挠	dhg
滤	viw
绽	zwd
竿	mae
炯	uld
诀	sxg
垮	bgz
舜	pwh
拴	doc
矫	mmn
馈	ojl
懊	ung
闸	tki
翎	owy
崎	lgj
倪	nnr
粪	ueo
蔼	esr
浊	viv
锤	pmb
褐	wkr
雯	fso
隧	ywg
嗤	jzi
叱	jrr
瘤	trk
溉	vxh
腮	qkw
扳	dpx
舶	pnk
屉	xez
蹦	jlq
炕	usq
桔	fbj
嚣	jjj
唾	jmb
贮	lwa
剔	krk
弧	yps
邢	aey
琉	csn
沦	vor
氓	syh
桓	fbk
踌	jcd
凿	kuz
炬	uhx
垄	gmb
娟	zjq
摹	ekm
庇	thr
脯	qfb
芯	ewz
泻	vwa
瓣	sps
肇	wmb
麽	tfz
栖	ffj
狸	qkb
篱	msz
喽	juz
棘	fll
瑾	cec
溶	vwj
眩	lsz
煎	uqv
诅	slc
竣	szr
蟹	rli
葫	eeq
诫	she
绥	zpz
兀	gra
诬	sbo
璧	xjs
敝	klm
裘	dvs
哆	jrr
彪	iqp
惕	uko
稣	rmf
玖	crs
傩	nxn
粥	yuy
懦	ufg
袄	wmg
砌	ghy
躇	jeb
忒	hwz
猾	qlw
廿	eaa
撩	dgk
匿	hej
雏	rxn
晖	kwh
驯	xnd
淌	vkl
椒	fix
怅	uch
佬	nbr
揍	dcg
搓	dub
冗	wqd
凰	qnc
梧	fbj
崛	lxz
淀	vwd
溯	vuq
猩	qkm
榆	fok
沼	vyj
翘	hgy
蚕	agi
邯	eby
嗨	jvz
拧	dwa
窍	wbz
唧	jxy
後	ozr
赂	lrj
轧	hez
忏	ume
樵	fnv
恂	urk
楠	fel
咚	jrt
钊	pkd
髓	lwq
铨	poc
噜	jrk
巳	yya
渝	vok
拯	dxa
蕉	env
豁	wcj
箫	mxo
嬷	ztz
蛛	imk
攒	dml
皂	nhd
寅	wao
悍	uke
呃	jgy
颐	hgo
绊	zub
楷	fhn
丞	xka
祠	wyj
蝉	iue
赎	leg
腥	qkm
沐	vfv
炽	ujo
渣	vfa
噗	jku
笃	mxv
淳	vsy
铲	psm
眺	lrv
嗜	jbk
蚊	iso
凹	iya
庶	tev
伽	nyj
唠	jey
棱	fbr
喔	jxh
鄂	jjy
沮	vlc
穗	mfw
峭	lkq
沁	vwz
揖	djc
捂	dbj
拭	dhb
溺	vyt
侈	nrr
酌	frs
揩	dhn
迦	wyj
涝	vey
曙	klb
漾	vuw
铮	prx
抿	dyh
驭	xxs
俨	nam
漓	vsz
槽	fek
迸	wue
敖	cym
赃	ltb
芮	elo
瘾	tyw
婷	zsa
肮	qsq
滕	quk
毋	zgd
猿	qbr
剃	uyk
涕	vuy
疤	tyi
咦	jgy
绎	zxb
雍	szn
沂	vpd
卦	bbi
仕	nbv
磅	gss
嘈	jek
憋	klw
彤	qsp
粤	nuz
盔	gul
怠	zjw
癫	teg
趴	jio
窖	wmj
祟	zzb
苇	eby
靡	tfk
畴	kcd
峨	lms
蚂	ixv
鬓	cpo
睫	lai
梗	fao
邸	rsy
唬	jiq
汕	vll
拇	dzy
闽	tli
绫	zbr
骸	lso
澈	vsm
赦	bnm
惫	rkw
殡	awo
裔	sld
苛	eaj
洼	vbb
霎	fsz
骏	xzr
芜	eag
瀑	vkk
舵	pwr
阜	mxe
汲	vys
筛	mkl
哝	jwr
痰	tuu
驹	xrj
淇	vec
惚	urw
奚	pzg
殆	azj
藩	evk
黝	lby
睬	lpf
晏	kwz
搔	dxi
嘀	jsl
悴	use
彷	osy
茹	ezj
喳	jfa
孚	pya
筐	mhc
曳	jhm
瑚	ceq
逞	wjc
瑛	ceg
擂	dfk
疚	trs
檀	fsa
攘	dse
侃	njn
涡	vjo
蒜	ebb
遁	wpl
窦	weg
桨	trf
矗	ell
韧	bys
晦	kmz
钝	phz
疮	toy
秧	mlg
啃	jiq
榴	frk
辙	hsm
踉	jsx
拌	dub
糙	uwj
墟	bik
骡	xkz
扒	dov
赣	skl
踊	jxl
娼	zkk
褪	wwx
偎	nkh
亥	szo
邑	jyi
锯	pxj
亟	yja
砚	glr
叽	jqd
鳞	ruh
朔	uzq
礁	gnv
锭	pwd
跄	joy
讪	sll
吭	jsq
憔	unv
於	sot
柿	fsl
捶	dmb
薯	elb
辄	hcz
槛	fkl
铎	pxb
纬	zby
驿	xxb
濒	vig
沅	vbr
哮	jby
嬉	zbj
狈	qlo
吆	jzz
刁	yav
嫣	zav
诏	syj
萃	ese
窒	whb
烹	syv
匾	hwl
拷	dbz
冕	krr
芷	eii
婪	ffz
笺	mhm
毡	mij
逍	wkq
叟	nix
酣	feb
钗	pxs
诛	smk
掺	dzp
狞	qwa
褥	wgd
渎	veg
惋	uwy
惦	utj
祺	wec
炫	usz
矶	gqd
醇	fsy
琅	csx
慑	ucx
殴	hoq
蕊	eww
咎	rij
磷	guh
萱	ewk
汀	vai
忱	uwr
炊	uro
铝	pjj
笋	mxb
奕	sng
濑	vfl
怦	uau
晁	krv
渥	vxh
扼	dgy
咄	jzz
掐	drn
赘	cyl
韶	skj
坂	bpx
撮	dkx
涤	vrf
匡	hcv
疙	tmy
阈	tha
戎	hgd
笙	mmc
沥	vgy
煽	uwy
隋	ygq
蹙	hij
媛	zpx
皓	nmj
霆	fyb
娄	uzm
吝	soj
茉	eaf
昊	kag
硫	gsn
菇	ezj
肴	ogq
寰	wlr
殉	ark
鬟	cpr
遐	wxx
褚	wbm
呛	joy
吠	jgs
猖	qkk
曝	kkk
茸	ece
戮	yyh
珑	cgm
瞟	lfb
锈	pmm
谛	ssl
恬	umi
甭	gld
挝	dwd
鹃	jqr
阙	tur
阱	ybn
埠	bme
甥	mky
酝	fbz
翟	yyn
碱	ghj
颅	ixg
聆	cow
勺	rys
酥	fmf
翡	kyy
馒	okx
憧	usb
墩	bsm
噩	cjj
哺	jfb
肾	kxq
祀	wyy
倔	nxz
雌	ihn
匕	rra
恤	uml
呸	jga
忡	uji
棣	fxk
恃	ubd
韬	byn
嗣	jlj
阑	tfl
鑫	ppp
哽	jao
奄	gkz
嗔	jeo
亵	sds
厥	gur
肋	qym
捍	dke
绚	zrk
茎	exb
觑	ikl
恺	uly
蹬	jxu
烙	urj
恪	urj
咆	jry
跺	jqf
缰	zck
亢	sqd
屿	laa
袅	rsr
彝	zae
弛	yyi
笠	msu
鞘	ekq
隅	ykz
鸳	ryr
谕	sok
俐	nmk
竺	mbd
诣	srk
仄	god
簸	mex
噬	jmo
蹋	jky
槟	fwo
秤	mau
羁	lex
筵	myi
呱	jps
粟	fuf
悖	uey
犁	mkm
璞	cku
锄	ply
岱	nhl
琵	ccr
憬	ukk
髻	cpj
舔	mau
盎	lgl
蔷	eej
榄	fkl
拗	dzy
漱	vfr
迢	wyj
嚎	jsg
拽	djh
嗒	jej
峙	lbd
孰	sys
幌	lkg
袒	wka
剿	zzk
桦	fne
臀	xeq
璋	cse
哧	jbo
腑	qtd
辗	hxh
蜘	imj
垢	bpj
黔	lbx
椰	fcy
犀	xkm
淤	vst
玺	rcs
痪	trg
矜	xmx
窿	wym
鹦	llr
梵	ffs
涧	vtk
啜	jxx
畸	kgj
歼	ame
臻	hcm
拎	dow
膳	quj
镯	pli
赈	lgh
宦	wdh
莞	ewr
橄	fxm
俟	nzm
绛	zrh
颔	osg
跤	jso
靶	eyi
囡	jzm
碘	glo
簧	meo
朕	qug
袊	wow
茧	eiv
炙	ruo
栩	fyy
饺	oso
簌	mfr
捻	dow
熔	uwj
谤	sss
馅	orn
啧	jcl
癖	txs
瘪	tnr
鸯	lgr
瞳	lsb
侥	nhg
岑	lox
咋	jmi
捺	dgb
耘	cbz
衅	mlu
蜷	iuy
趾	jii
荧	ewu
缭	zgk
屎	xuf
滇	veo
褒	snf
壕	bsg
妍	zae
潺	vxy
萦	ewz
谍	sef
荔	eyy
妲	zka
囱	nrs
焊	uke
瞿	lln
葆	enf
胥	xiq
堰	bhz
碳	glu
谒	skr
珏	ccs
叁	zgc
滢	ves
鸥	hor
殃	alg
瘩	tej
渤	vey
麓	ffr
纂	mlz
碾	gxh
唁	jsv
瘟	tkl
囔	jer
掣	mlm
讷	slo
曦	kus
捎	dkq
浚	vzr
蹑	jcx
拈	dij
渍	vcl
屹	lmy
泌	vwm
毗	khr
睐	lbk
咀	jlc
垣	bbk
胭	qjd
汶	vso
戊	hma
憨	xcw
驮	xgd
冢	wgs
偕	nhn
瓢	fbp
霹	fxs
猝	qse
篓	muz
昵	kxr
踞	jxj
腺	qnk
紊	soz
贻	lzj
诲	smz
禾	mfa
佯	nuc
凋	tlj
羔	ucv
渭	vkq
桅	fry
隘	yul
锥	pni
镀	ptx
悚	ufj
辕	hbr
榨	fwi
橙	fxu
圃	jfb
惰	ugq
弩	zxy
岐	lex
攫	dlx
舷	psz
茬	egb
芹	epd
陇	ygm
漉	vtr
栓	foc
甄	fbs
箍	mdl
硝	gkq
惮	uue
烽	urc
椎	fni
绯	zkc
恙	uwz
蜒	iyi
腆	qlo
浒	vse
嫖	zfb
靳	epd
吮	jzr
淄	vzk
菁	ecq
喋	jef
穹	wyz
辍	hxx
醺	fmv
撵	dbh
盹	lhz
噎	jbu
谏	sfl
壑	iwb
戟	ehm
癞	tfl
啄	jgs
熠	uyn
篆	mzg
惺	ukm
锚	pek
毓	mzn
跻	jsn
豚	qgq
琶	ccy
寐	wzk
鹊	ekr
鹉	ahr
玮	cby
漳	vse
葵	exg
枷	fyj
痹	tkn
臊	qjf
酪	frj
雳	fgy
睨	lnr
馋	ort
峦	sll
跷	jhg
铐	pbz
笆	myi
锵	ptd
迂	wad
抡	dor
甬	xld
卯	rmy
涎	vyi
踵	jmb
钳	peb
挹	djy
悸	umy
炜	uby
帚	xwl
暄	kwk
巅	leg
盅	jil
谑	sia
蛊	ilk
坍	bqs
缤	zwo
秆	mae
姗	zqa
澎	vbp
獗	qgr
闵	tso
嵩	lsj
翌	yys
钵	pfa
皖	nwr
厩	gxh
纣	zds
薰	emv
蔗	etv
沌	vhz
婊	zcr
蹭	juk
坞	brz
妩	zag
谚	ssp
浣	vwr
惆	ulj
筠	mbt
硅	gbb
扉	wkc
酉	fda
撅	dgr
挛	smd
幔	lkx
郸	uky
撂	dkj
喏	jej
幺	zzd
娓	zxm
嗟	jub
伫	nwa
筏	mnh
烯	uol
瘸	tyo
螃	iss
粱	vyu
熹	bjv
汾	voy
鸠	qrz
惴	ulg
邃	wwg
荀	erk
嚓	jwb
唆	jzr
坷	baj
秸	mbj
渲	vwk
佼	nso
泵	gkv
籽	uya
拄	dsc
蠕	ifg
蕃	epk
蜿	iwy
瑙	czo
荟	eoz
飕	qox
孺	yfg
蛟	iso
讴	sho
骋	xkz
藕	ecz
搐	dsk
濮	vnu
蛾	ims
梓	fse
嵇	mgl
崽	lkw
伎	nex
腼	qgb
刨	ryk
籁	mfl
捅	dxl
痉	txb
塾	syb
痊	toc
烬	uxt
潦	vgk
啐	jse
飒	sqo
恣	trw
叼	jya
镐	psj
帛	nli
弼	yay
泞	vwa
迥	wld
缄	zhj
抉	dxg
泓	vyz
飙	gso
剌	fjk
瞰	lxm
铿	pkb
沽	vej
鸾	srz
萤	ewi
褶	wyn
睿	iwl
稠	mlj
枭	rzf
龛	oag
椿	fco
瑕	cxx
恻	ulk
镣	pgk
腋	qsr
蝠	iak
蘸	efv
噤	jfb
侬	nwr
髯	cpb
隽	nym
砾	grk
孵	rsy
榕	fwj
氢	mxb
柑	feb
夙	qar
呷	jki
潍	vzn
闩	tla
咂	jhl
偌	nej
舫	psy
摒	dxe
邬	rzy
愫	ucz
讹	snr
啬	euj
谆	ssy
涟	vwh
戍	hms
璀	cln
阪	ypx
掳	diy
璜	ceo
瓮	ozs
煦	krv
暧	kpx
攥	dmz
鼾	nke
亘	bdk
莘	ese
镌	pnm
玷	cij
漩	vsi
傀	nnj
啰	jlr
沏	vhy
檬	feg
稷	mkr
峪	loj
苞	ery
诽	skc
瞌	lbl
腌	qgz
娣	zuy
麒	txe
咻	jnf
遽	wig
赡	lrs
惬	uhu
徨	onc
狩	qwd
椭	fyq
柠	fwa
斡	eoe
瀚	vey
蹊	jpg
佃	nki
镰	ptx
跛	jxi
禺	klz
馁	opz
蛰	dqi
蛤	ioj
湃	vmc
臾	nod
霭	fsr
骰	lqx
胚	qga
晾	ksk
蚌	ici
舐	mrh
簪	mhk
篡	mlz
髅	luz
莓	emz
儡	nkk
懿	bww
徇	ork
漪	vqj
皎	nso
霏	fkc
鲤	rkb
梆	fcy
璨	ciu
缨	zlz
卞	sid
玑	cqd
鹭	jrr
蘑	etg
彗	ccx
瘠	tvq
淆	voq
赊	lob
唷	jsq
锹	pmu
阖	tbl
鲸	rsk
袂	wxg
燎	ugk
姣	zso
荤	ewh
诙	sgu
瘁	tse
俾	nne
诘	sbj
纫	zys
逵	wbb
汩	vkv
欤	azr
垛	bqf
掬	dru
掇	dxx
骷	lej
羲	ums
掂	dtj
殓	aov
绉	zrx
蹂	jxf
撬	dmm
倌	nwx
鬈	cpy
皋	nge
憩	mnw
坯	bga
搪	dtj
膺	tnq
臧	hzh
氨	mwz
帼	ljs
钙	paz
钰	pcs
臆	qsw
饯	ohm
跚	jqa
氯	mxk
敕	fjm
皙	fpn
芥	eon
幡	lpk
纶	zor
骥	xto
藐	epr
昕	kpd
铢	pmk
苓	eow
祯	wil
躏	jen
卤	ijo
鳄	rjz
筱	mnm
掖	dsr
涸	vjj
箕	mec
涣	vrg
蝙	iwl
樟	fse
抨	dau
缥	zfb
刽	obk
踝	jkf
蹒	jef
嫦	zkl
饷	onj
戌	hma
冽	tak
鳖	klr
衢	oln
辘	htr
琨	ckr
酵	fby
纨	zqs
谟	seg
蹩	klj
俑	nxl
谧	swl
隍	ync
榭	fnd
貂	pyj
遛	wrk
绺	zrj
鳌	cyr
悻	ubu
碴	gfa
丕	gia
匮	hjl
杳	fkv
垸	bwr
蝗	inc
謇	wes
黠	lbj
睑	lov
怂	oow
睽	lxg
哒	jwg
珮	cql
茗	erj
潆	vez
俸	ncb
岖	lho
濡	vfg
宕	wdg
蟒	iee
蟆	ieg
琥	ciq
罔	lda
坳	bzy
忑	aiw
偃	nhz
珈	cyj
褴	wkl
攸	nim
徙	oii
讫	smy
虱	ymi
掸	due
忐	iaw
舀	pnb
啾	jmu
蜕	iur
褛	wuz
诠	soc
罡	lai
闰	tlc
劾	szy
熨	xbu
桀	rhf
斓	stl
茁	ezz
胄	kiq
匝	hli
恸	uby
槌	fwx
怆	uoy
黏	moj
炖	uhz
轶	hmo
咫	xso
猥	qkh
脓	qwr
疵	tir
潢	veo
抠	dho
蜗	ijo
谄	srn
泸	vix
馀	oom
泗	vlk
擞	dum
铛	pkx
湍	vlg
柩	fhs
狰	qrx
鹄	mjr
恿	xlw
肪	qsy
衲	wlo
鄱	pky
戛	anh
旌	smm
瞠	lkb
湄	vxl
豺	pdm
蹿	jwi
杞	fyy
杼	fxx
蛀	isc
芋	ead
篝	meb
羚	uow
咔	jii
谙	ssk
釜	oou
孀	zfl
犊	meg
嗬	jej
诿	smz
雹	fry
扈	wjy
镂	puz
皑	nly
禧	wbj
卅	and
啷	jsy
蜓	iyb
艮	xoa
藜	emk
颉	bjg
瀛	vss
垠	bxo
阂	tso
涓	vjq
蜻	icq
锌	pse
媲	znr
脐	qsn
颧	ejg
羿	yye
耦	ckz
馥	mkr
踹	jlg
掰	mom
琏	cwh
衾	oss
虬	izv
谀	sno
蜚	kci
喟	jkq
疟	tha
噙	joz
蟀	ise
妪	zho
耙	cyi
嚅	jfg
橇	fmm
俎	ool
蟋	ipw
缈	zlm
糜	tfu
礴	ged
锢	pjj
酗	foz
皿	lka
赳	bzi
潼	vsb
臃	qsn
楫	fjc
嚏	jei
鹳	ejr
裱	wcr
摈	dwo
锺	pmb
恁	nmw
町	kai
倭	nmz
嗫	jcx
耷	gce
呗	jlo
搽	def
懋	fxw
龊	iji
氟	myn
瞑	lwo
氮	muu
燮	usx
弁	zde
荻	equ
翱	ngy
骈	xue
迳	wxb
陲	ymb
睇	luy
鲨	vkr
屐	xox
鬃	cpb
粽	uwb
榈	ftj
圩	bad
荼	eom
龌	ixh
捱	dgb
婕	zai
傣	nck
铧	pne
鳗	rkx
磐	pqg
咿	jnx
犷	qtg
壬	mbv
灸	rsu
骅	xne
霁	fsn
隼	ned
弈	sne
缮	zuj
诌	srx
嗥	jne
嘹	jgk
烨	une
粼	urz
挎	dgz
咛	jwa
怏	ulg
忸	uxe
杵	fme
胰	qgy
疹	top
窠	wkf
捋	dpd
斫	gpd
啻	swj
瘴	tse
颦	ike
眈	lwr
庠	tuc
慵	utq
荃	eoc
侗	nld
颏	szg
嗖	jnx
崓	ljj
虻	ish
洙	vmk
媪	zkl
铀	pki
牒	nef
濂	vtx
嵋	lxl
蛐	ikk
犄	mgj
怩	uxr
泯	vyh
臼	nba
箩	mlr
腴	qno
篙	msj
溥	vfd
栾	skf
嫡	zsl
踮	jtj
螂	isy
贰	hbl
柚	fki
鸨	rer
珞	crj
懵	uel
兖	sor
骼	lrj
栉	fey
傧	nwo
僮	nsb
淞	vfz
羌	ucz
铠	ply
粲	iru
牍	neg
菠	evx
昙	kbz
覃	fke
戾	wgs
峒	lld
飓	qoo
夯	gym
匍	rfb
谩	skx
仃	nai
啕	jrl
泷	vgm
舸	paj
桧	foz
泾	vxb
橹	frk
箴	mhj
娩	zrr
摞	dkz
吒	jmh
呓	jey
蟠	ipk
泠	vow
癸	xog
啮	jio
淅	vfp
爿	zig
涿	vgs
嘁	jhk
纭	zbz
噼	jxs
锲	pcg
嶙	luh
髭	cpr
唏	jol
饪	omb
痞	tgj
颚	jjg
揿	dpr
噫	jsw
阉	tgz
噶	jer
沱	vwr
闾	tjj
涔	vlx
噘	jgr
苯	efa
畦	kbb
拋	dgy
芍	ers
恫	uld
蓟	erk
岌	lys
囗	jda
颍	rkg
胫	qxb
鸵	rwr
饽	oey
婀	zyj
泱	vlg
子	yaa
孑	yaa
拮	dbj
陨	yjl
蒿	esj
裨	wne
狒	qyn
峋	lrk
孪	sya
翊	syy
钾	pki
蚤	xsi
湮	vfb
雉	mni
剁	qfk
佚	nmo
娑	vkz
淙	vwb
揄	dok
挞	dwg
诋	srs
埂	bao
曜	kyn
馍	oeg
痣	tbw
煜	uks
骁	xhg
氅	klm
祛	wbz
豢	ugq
昱	ksu
酶	fmz
蹴	jsg
痨	tey
魇	ggn
邋	wzz
滂	vss
榛	fcm
箔	mvn
蛆	ilc
嫔	zwo
刍	rxb
萼	ejz
嵘	lef
蜈	ijg
滦	vsf
聿	xbi
怵	ufs
痘	tau
飨	zzo
囤	jhz
佻	nrv
骠	xfb
盥	nbl
靓	cql
槁	fsj
痢	tmk
缜	zeo
蚣	ioz
颀	pgo
窈	wzy
忻	upd
悒	ujy
玳	cnh
宓	wwm
鹑	syr
侏	nmk
惇	usy
楹	fyl
茴	ejj
剽	fbk
糠	utk
聒	cmi
诳	sqc
滓	vws
椽	fzg
麾	tfm
脍	qoz
淖	vie
皈	npx
砺	ggy
蹶	jgr
袤	sxm
匐	rak
赭	bnb
砥	grs
搡	dxf
罹	lun
鹫	skr
瑁	ckl
涪	vsj
咤	jwh
洵	vrk
菏	evj
迤	wmy
鞑	ewg
诩	syy
霾	fpb
佥	obv
蟾	irs
摺	dyn
睾	mlu
澧	vku
衮	soz
靥	ggb
诮	skq
倜	nlj
胤	rzq
箸	mbm
袈	yjs
腓	qkc
驷	xlk
麝	txd
唰	jxk
裟	vks
韭	kca
馔	oyo
诒	szj
驸	xnd
豌	ajy
洱	vce
绶	zpx
佞	nbz
仞	nys
饬	omy
遢	wky
饨	ohz
踅	dpj
笈	mys
熵	usl
嘤	jlz
濯	vyn
懑	vew
粕	unk
窕	wrv
胯	qgz
渚	vbm
笞	mzj
囿	jgq
楂	ffa
撷	dbg
偻	nuz
贲	eel
钛	pgs
堑	hpb
钅	paa
宸	wgh
湎	vgb
铉	psz
獭	qfl
觐	ejl
嗝	jal
骊	xal
辔	zhj
俪	nal
涮	vxk
谥	sul
澹	vrs
孛	ewy
逅	wpj
罅	mlu
赧	bnx
橐	ejf
俚	nkb
酩	frj
磺	geo
郅	hby
梏	fmj
猷	ufs
嗑	jbl
鹞	pmr
箨	mdb
榔	fsy
觞	rlo
邝	tgy
酊	fai
峥	lrx
伧	noy
蚓	iyi
喁	jkz
翳	hmy
嬴	sjs
耆	brk
釉	pki
怄	uho
鲫	rxy
愠	ukl
耄	brm
咝	jza
罄	bxl
哂	jfj
邂	wrm
谪	ssl
疸	tka
诨	swh
糯	ufg
祗	wrs
蹇	wej
巽	yyo
讣	sid
荞	emn
旖	smj
馄	okr
碚	gsj
犭	qma
碉	glj
浃	vbu
诰	smj
嗷	jcm
庾	tno
狙	qlc
蜃	ghi
纾	zxx
绦	zrf
遨	wcm
谗	srt
汴	vsi
鏖	txp
蚯	ipd
弋	hsa
郜	mjy
豕	gqa
阕	txg
痫	ttf
崴	lhz
鹂	alr
韫	byl
庖	try
芊	eme
婵	zue
奁	gho
莆	efb
遑	wnc
桠	fak
戬	akh
樽	fud
岫	lki
挈	cym
泅	vjo
磬	bxg
扪	dtl
蚩	zai
蛎	igy
狎	qki
劭	yjy
膘	qfb
聃	clb
揶	dcy
徉	ouc
钠	plo
唢	jkl
迩	wrk
郢	jcy
恹	ugs
剐	jlk
钏	pnd
靼	eka
掮	dwq
翦	uqy
晔	kne
楔	fcg
珉	cyh
祚	wmi
噔	jxu
酯	frk
飚	qou
胺	qwz
蝌	ime
碜	gzp
矾	gqs
畹	kwy
莅	ens
娌	zkb
钺	phm
绌	zzz
桎	fhb
茏	egm
呶	jzx
徜	okl
铤	pyb
妯	zki
姘	zue
浔	vxd
骞	wex
锃	pjc
遴	wuh
帏	lby
钿	pki
濠	vsg
哔	jhe
鸢	hrz
淬	vse
镍	pnf
镁	pug
鳅	rmu
圜	jlr
蠊	itx
暹	wkn
黍	mok
缢	zul
浜	vpo
蚪	ite
焘	cmv
牝	mrr
黜	lbz
挲	vkm
琬	cwy
啵	jvx
鹌	gkr
箧	mhu
榷	fwn
徵	olm
铡	plk
墒	bsl
棂	fxu
猢	qeq
乩	ijz
徕	obk
啖	juu
旎	smr
趄	blc
斛	rle
葩	eny
忤	ume
穰	mse
谲	sxl
喙	jzg
崆	lwb
蔻	ewx
咭	jbj
蟑	ise
叵	hjv
銮	skp
潸	vfq
裆	wkx
潞	vjj
撺	dwi
篪	mpq
杈	fxs
辇	boh
藓	eru
嘭	jbp
孱	xyy
粑	uyi
翕	oay
篾	mls
觊	lyl
肛	qbi
夥	kfr
擤	dnn
瓯	hos
蠹	eji
琮	cwb
绔	zgz
邕	zzy
罂	lll
诟	spj
宥	wgq
侩	noz
柢	frs
幛	lse
觎	oal
牦	mmh
鸪	ejr
濛	veg
獏	qeg
褡	wej
弨	yyj
麋	txu
辶	waa
绡	zkq
岬	lki
幄	lxh
戕	zgh
轲	haj
夔	uir
蚱	imi
缙	zak
骛	xmx
氲	mkl
龇	iir
烷	uwr
孳	uzy
铄	prk
睢	lni
疡	tyo
娲	zjo
僭	nhk
俳	nkc
煨	ukh
颌	oag
烩	uoz
鳝	ruj
狲	qyk
阒	tls
昀	krt
忪	uoz
镫	pxu
萋	eaz
猬	qkq
嶂	lse
遒	wuf
冼	tmr
胛	qki
祉	wii
揆	dxg
艄	pkq
訇	rys
勖	kly
诤	srx
牯	mej
绾	zwx
殒	ajl
伉	nsq
歆	skr
鳍	rbk
玢	coy
襁	wyi
郴	ffy
岷	lyh
漯	vkz
犒	msj
淼	kkk
谡	skr
柘	fgv
悌	uuy
莒	ejj
爰	pax
誊	ubs
褓	wnf
燧	uwg
傥	nkr
荩	ext
忾	umy
聩	cjl
珩	coi
蓑	esk
鸷	dqr
綦	ecz
螫	bni
锏	ptk
佰	nan
溟	vwo
踽	jml
荏	enb
檄	fnm
瘀	tst
喑	jsk
杓	frs
鳏	rlt
嗄	jar
荚	ebu
鹗	jjr
殚	aue
镳	ptv
啭	jhs
箝	mde
蓿	ewn
痼	tjj
氤	mjd
滟	vcy
靛	cqw
馏	ork
胱	qkg
焱	uuu
觥	rlg
焙	usj
鹧	ter
邈	wpr
钹	pgs
壹	bwu
糅	uxf
赍	eol
邺	kuy
碣	gkr
蜢	iyl
茯	ens
镛	ptq
欹	gar
亻	naa
锷	pjz
稔	mow
莠	emm
殳	qxa
蔺	etn
铰	pso
笏	mro
猕	qyr
镭	pfk
杷	fyi
佗	nwr
铱	psr
钜	phx
伛	nho
逡	wzr
裾	wxj
殇	amo
痔	tbd
蠡	zgi
陂	yxi
曷	kry
舂	cnb
砧	gij
鲑	rbb
侪	nsn
奘	zgg
螅	inw
娉	zkz
汞	bkv
葺	ejc
掼	dzl
堇	ejc
薮	eum
猡	qlr
赝	gnl
昶	wvk
蹰	jgd
龃	ilc
姝	zmk
迨	wzj
焖	utw
枇	fhr
榉	fvb
癣	tru
垴	bsz
毽	myb
硒	gfj
棹	fie
忝	agu
雠	nsn
汨	vkv
瓴	ows
鹘	lrz
恽	uwh
栎	frk
砭	gmw
圻	bpd
苜	elv
嬗	zsa
酮	fld
汐	vrs
狷	qjq
猗	qgj
诓	shc
邙	shy
郧	jly
晟	khy
醮	fnv
矍	llx
衿	wox
蹓	jrk
畿	zzk
咩	juc
喵	jek
砒	ghr
臬	nlf
儆	nem
赓	txl
繇	pmz
淦	vpv
鲈	rix
舢	pll
鳟	rud
仨	ncd
枞	foo
佝	nrj
牖	nwf
崂	ley
隗	ynj
沭	vfs
陟	yik
炷	usc
倨	nxj
弑	ofb
幂	wkl
饕	jao
伕	nbo
僖	nbj
锉	pob
鹜	xmr
磴	gxu
灏	vkg
仟	nme
蛔	ijj
掴	djs
阡	yme
讦	sae
殁	aqx
湟	vnc
鄢	aiy
稗	mne
胴	qld
媾	zeb
瘢	tpq
婺	xmz
刎	rok
龉	ibj
穑	mej
炀	uyo
滁	vym
螳	ikb
铣	pmr
姹	zwh
贽	dql
秭	mmm
蜥	ifp
煊	uwk
蕨	egr
铵	pwz
彀	bwq
罘	lgi
寮	wgk
趿	jys
得	okd
刈	okd
肱	qgz
蜴	iko
痧	tvm
闳	tgz
肄	rmb
剜	wrk
茔	ewb
旮	qyk
蝈	ijs
騡	xnk
竽	mad
躅	jli
醴	fku
鱿	rgr
闼	twg
鲲	rkr
痍	tgy
跎	jwr
魉	nfo
囹	jow
吶	jlo
菡	exz
赉	bkl
眇	lkm
邳	gay
癯	tln
耋	brh
鸩	wrr
轭	hgy
诂	sej
酽	fam
娆	zhg
啁	jlj
笤	myj
摭	dtv
蹉	jub
逶	wmz
趔	bak
辚	huh
葳	ehz
簟	mfe
擢	dyn
鬻	yul
旯	kqy
蛹	ixl
愎	umr
嵬	lnj
妊	zmb
唿	jrw
堞	bef
寤	wzj
犟	yjm
烃	uxb
桁	foi
阗	teo
呦	jzy
貉	prj
噱	jig
馊	onx
逦	wal
鲟	rxd
奂	rlg
疣	tgr
霈	fvl
仝	obi
擘	xjm
谯	snv
毂	bwq
锨	ppr
骜	cyx
偈	nkr
篑	mjl
锰	pyl
踯	juy
磔	grf
凫	rqd
辎	hzk
畲	obk
琰	cuu
跆	jzj
恚	bbw
獠	qgk
郗	ogy
帙	lmo
砷	gki
蘅	eog
赅	lso
蜍	iom
氰	mcq
囵	jor
渌	vxk
蒯	eqk
獐	qse
籼	ull
哏	jxo
撸	drk
嗲	jor
瓤	sjp
佘	obk
坻	brs
钡	plo
讵	shx
骧	xse
妤	zxx
苎	ewa
尕	ymk
娠	zgh
璎	clz
睃	lzr
荑	egy
觯	rle
谌	sez
鸱	rsr
蕲	eup
铬	prj
祜	wej
笳	myj
闱	tby
歙	oar
菽	eix
瞽	bjl
亳	swh
硷	gov
餍	ggo
溧	vff
羸	sjs
荥	ewk
纡	zad
馗	qun
苒	elb
沤	vho
囫	jro
蟮	iuj
菅	ewx
鼐	ymx
疽	tlc
壅	szb
蔫	eav
颛	lgg
氖	mym
哞	jzm
鼋	brz
裢	wwh
砀	gyo
氵	vaa
秣	maf
烊	uuc
钎	pme
铆	pry
阆	tsx
噹	jkk
缛	zgd
郛	pyy
樾	fbh
岿	lkx
矇	leg
枰	fau
抟	dbs
垅	bgm
珐	cbz
鲧	rmz
魑	nsz
缫	zzf
嫚	zkx
凇	tfz
酰	fmr
艹	eaa
焯	uie
阚	txm
漕	vek
衩	wxs
黧	mrv
骝	xrk
懔	usb
褊	wwl
悭	ukb
鄞	ejy
阄	trz
垩	akb
暝	kwo
橛	fgr
墀	bxm
馑	oec
椋	fsk
佤	nas
涞	vbk
鬣	cpz
锟	pkr
绻	zuy
麂	txq
稞	mkf
骘	yix
崧	lfz
阍	trk
愀	umu
逖	wqu
廪	tsb
藁	esf
庑	tag
畀	kan
屣	xoi
蹼	jku
竦	sfj
蝼	iuz
枸	frj
悱	ukc
逋	wfb
峤	lmn
唳	jws
髑	lli
怫	uyn
钚	pgi
荠	esn
膻	qsa
玟	cso
劬	rjy
詈	lks
螨	ief
辊	hkr
郓	why
郦	aly
龈	ixo
镞	psm
馐	oue
饴	ozj
眬	lgm
囝	jya
颢	ksg
痈	tld
砉	cig
钤	pox
湫	vmu
辂	hrj
圄	jbj
霰	fem
龋	iml
舛	rhi
驽	zxx
阋	tnr
蜮	iha
顼	cgo
缱	zwx
起	byy
圮	byy
邛	biy
萸	eno
稹	meo
眦	lir
郯	uuy
摁	djw
樨	fxm
盍	bzl
葚	eez
嵊	lmr
擀	dee
轳	hix
樯	fej
桡	fhg
缟	zsj
砝	gbz
儋	nrs
椁	fsy
魍	nld
逄	wrh
拶	dzr
蜇	dpi
莼	ezz
勰	yyw
甯	wwl
箬	mej
嘣	jlq
汊	vxs
燹	ggu
耒	cka
泫	vsz
篁	mnc
戆	skw
蘖	emf
泮	vub
狺	qms
疱	try
廛	tkb
沆	vsq
皴	zox
痂	tyj
溆	vox
虢	pdq
鸶	zzr
蘧	ewg
糗	uns
吋	jds
谶	soa
帔	lxi
缃	zfl
栀	fpy
乜	yzv
柞	fmi
蓖	enr
禳	wse
隳	ygu
纰	zhr
鹈	uyr
鹬	xmr
孬	gzy
笥	myj
抻	dki
鹕	ejr
豸	pqa
薹	ebh
孢	yry
苴	elc
鸫	hkr
伥	nch
猱	qxf
珺	cxj
叻	jym
旃	sms
呎	jxs
搦	dyt
酚	foy
疥	ton
笸	mhj
鲇	rij
羼	xuu
苫	eij
钒	pqs
珲	cwh
薨	elr
矸	gae
轸	hop
韪	kby
饧	oyo
跹	jwm
彘	zar
枥	fgy
鋈	vmp
锂	pkb
筮	mbo
虳	irs
闇	tsk
篦	mnr
蛭	ihb
荨	exd
塍	qub
苕	eyj
趵	jrs
粳	uao
塬	bgk
婠	zwx
鲠	rao
睥	lne
溴	vns
镊	pcx
獾	qen
谵	srs
厝	gek
荦	ewm
蓼	eyp
蚜	ihi
阃	tjf
狯	qoz
籀	mdk
佶	nbj
嫒	zpx
曩	kse
椴	fnq
搠	duq
辏	hcg
硼	gqq
铳	psr
哙	joz
雒	rjn
诼	sgs
拊	dnd
洌	vak
楮	fbm
蒺	etm
莴	ejo
哓	jhg
哐	jhc
澌	vep
怃	uag
撄	dlz
怼	xdw
鲛	rso
瑗	cpx
螟	iwo
镒	pul
疖	tyv
溘	vbl
绂	zgs
雎	lni
崮	ljj
碓	gni
酢	fmi
簦	mxu
镗	pkb
汜	vyy
箪	mue
芘	ehr
洮	vrv
苣	ehx
蜉	ipy
窨	wsk
瀣	via
讧	sbi
缁	zzk
垓	bso
葭	exx
钯	pyi
殄	aop
嘬	jkx
夤	rwo
晷	krj
衽	wmb
彖	zgq
妫	zus
芾	eal
锱	pzk
訾	irs
膈	qal
谝	swl
缦	zkx
蚝	imh
峄	lxb
嫱	zej
笄	mae
嘞	jey
碇	gwd
鼬	nzk
墉	btq
祓	wgs
爻	oos
洎	vnl
珪	cbb
飧	rox
垭	bak
酡	fwr
趱	bml
槎	fub
箓	mxk
渑	vjz
搴	wem
醯	fsl
柟	flb
蒗	evx
甑	uls
坨	bwr
朐	qrj
侉	ngz
桉	fwz
炔	uxg
铩	pof
榫	fne
硐	gld
喈	jhn
砻	gmg
祢	wrk
猓	qkf
侑	ngq
桷	frl
趺	jbo
扦	dme
姮	zbk
嫠	bkz
镬	pex
螭	isz
邡	syy
胪	qix
噌	juk
珣	crk
鹮	lar
髋	lwl
髀	lne
咣	jkg
庥	tnf
瑷	cpx
蛩	bqi
洄	vjj
骀	xzj
勐	yly
昝	rik
蚨	ibo
肫	qhz
疋	xii
溷	vjg
苋	elr
鼹	nzz
餮	aoo
庋	tex
漶	vjw
螓	icm
妁	zrs
畈	kpx
羯	ukr
妗	zox
锒	psx
踟	jmj
鳕	rfx
葸	ekw
蓊	eoy
澍	vbd
肽	qgs
峁	lry
嗐	jwj
掾	dzg
谠	skr
帑	zxl
谔	sjz
卮	pay
腭	qjz
茕	ewe
颡	xxg
腱	qyb
膂	smq
鼍	jjz
陉	yxb
暾	ksm
菸	est
焐	ubj
傈	nff
糍	uuz
珙	ceo
疴	taj
醪	fyp
鳎	rky
杲	kfv
鞯	eey
薜	exs
鳃	rkw
慊	uux
膑	qwo
潋	vom
跖	jig
痱	tkc
蜊	imk
觚	rlp
灞	vfq
蕖	evf
妳	zrk
阼	ymi
诎	szz
缇	zkv
砦	irg
缒	zwx
髫	cpj
戢	jcs
氦	mso
轱	hej
肓	shq
槿	fec
桕	fnb
钴	pej
呲	jir
僳	nfu
俦	ncd
蛳	ikl
煲	nju
馕	oer
栊	fgm
绀	zeb
仵	nme
瓒	cml
醢	fgl
嚃	jwt
椤	flr
郏	buy
蓁	ecm
嵯	lub
骢	xnw
沔	vay
莪	ems
铙	phg
楝	ffl
鞣	exf
谰	stl
绁	zez
杌	fgr
嚯	jfn
怙	uej
柰	fbk
荇	eoi
愦	ujl
罴	lbv
薏	esw
黩	lbg
阏	tst
鎏	vsp
芟	eqx
扃	wld
僦	nsg
錾	hpp
锶	pkw
欷	ogr
屺	lyy
菖	ekk
齑	sna
蒡	ess
槊	uzf
鲂	rsy
菰	eyp
俅	nds
毵	zgm
魈	nkq
埽	bxl
瓠	gbp
锗	pbm
蛉	iow
喱	jgb
芗	ezz
鸹	mrz
蠲	uoi
裥	wtk
觳	bwq
缗	zyk
爨	nbu
倥	nwb
畚	zgk
扌	daa
疠	tay
圹	btg
皤	npk
媸	zzi
砣	gwr
赀	irl
纥	zmy
仉	nqd
碛	gcl
嗾	jsm
蝣	isy
髡	cpg
伢	nhi
蚋	ilo
荸	eey
矽	grs
蓍	ebk
嶷	lri
鸬	ixr
鞅	elg
鲋	rnd
郄	ogy
苌	ech
趑	btr
腈	qcq
醍	fdk
呔	jgs
屦	xoz
湜	vkv
浠	vol
旄	smm
蠃	sjs
盱	lad
醛	fec
氐	rhs
桴	fpy
蒹	eux
虺	gri
骐	xec
蕤	egm
莳	ekd
揎	dwk
缶	mll
岘	llr
麇	txm
骓	xni
炝	uoy
苻	end
樗	ffz
笪	mka
芨	eys
姒	zzo
惝	ukl
裰	wxx
芰	eex
茭	eso
骖	xzp
纛	czz
秫	mfs
硌	grj
缬	zbg
翥	byy
癜	txq
钼	plv
蟊	xmi
醐	feq
泐	vyy
佾	noq
絷	dqz
蹀	jef
卟	jid
捭	dne
钨	prz
掊	dsj
醚	fwu
阊	tkk
诔	sck
燔	upk
戡	ezh
榇	fsf
仡	nmy
觇	ijl
椠	hpf
仫	nmz
缣	zux
鹚	uzr
逑	wds
翮	ajy
嗵	jwl
獒	cys
徼	onm
麸	cro
嬖	xjz
缧	zkz
晗	koj
脔	slo
嬛	zlr
圪	bmy
缯	zuk
矞	xml
氡	mrt
蜣	iuz
嫫	zeg
凼	kzi
堃	ssb
迓	whi
柙	fki
淝	vqy
镏	prk
唑	job
褫	wpq
蚶	ieb
燠	ung
杪	fkm
坼	bps
狻	qzr
艿	eym
邰	zjy
婧	zcq
鹩	gur
殍	apy
笾	mwy
跸	jhe
瘰	tkz
钲	pai
搿	mom
堀	bxz
锜	pgj
棼	ffy
嘏	ejx
帻	lcl
镝	psl
怿	uxb
枳	fjo
呖	jgy
珥	cce
觌	exl
睚	lgb
罾	luk
芪	erh
舁	nbe
圉	jbu
偬	nrw
釆	pfa
琚	cxj
榧	fhk
媵	quz
螯	cyi
縻	tfz
黢	lbr
戗	oyh
镢	pgr
蓥	ewp
鞫	ers
涫	vwx
旒	smn
楸	fmu
苷	eeb
孥	zxy
豉	ajx
魃	ngs
隰	ykv
鼙	bje
菟	ers
粜	zzu
簏	mtr
锩	puy
匏	gby
捩	dws
锴	phn
吡	jhr
窳	wpp
臁	qtx
砼	gob
茌	enb
跣	jmr
槲	fre
筌	moc
舨	ppx
跫	bqj
眙	lzj
馓	oem
厶	zda
蠛	ies
搧	dwy
纟	zaa
镉	pal
瘘	tuz
柝	fps
缑	znm
鲱	rkc
瘗	tbb
埴	bel
泔	veb
蚬	ilr
滹	viu
毖	hrm
瞀	xml
洹	vbk
殭	ack
暌	kxg
蠓	ieg
廴	yaa
蠖	iex
濉	vln
牾	mbj
剡	uuk
铋	pwm
襦	wfg
铂	pnk
眄	lay
槃	pqf
槠	fsb
驺	xrx
捌	djk
尻	xqy
砑	ghi
哜	jsn
躞	jux
鏊	cyp
蛄	iej
呣	jzy
镪	pyi
菹	evl
觋	bol
禊	wcg
狍	qry
邗	aey
垆	bix
腚	qwd
唣	jnh
刖	qkd
筚	mhe
潴	vqb
赜	hcl
忄	uaa
舄	nrv
轫	hys
酆	ccy
黻	kks
饫	omg
遄	wlg
晞	kol
傕	nwn
箐	mcq
沣	vci
锑	puy
楦	fwk
蝮	imr
暐	kxh
黾	jkz
梃	fyb
蹚	jkb
悫	bww
埒	bpd
萁	eec
脩	niq
椹	fez
煅	unq
徂	olc
埭	bxk
鄯	uuy
麈	txc
棰	fmb
岜	lyi
褙	wtq
鳜	rgr
槭	fhk
怍	umi
鹁	ewr
邾	mky
荜	ehe
笫	mmm
愍	yhw
埙	bjl
逭	wwx
盃	glk
畋	kmo
犍	myb
熳	ukx
诜	smr
诖	sbb
诹	scx
泚	vir
岙	mgl
牠	myi
莜	enm
笊	mpv
宄	wqy
玎	cai
裎	wjc
棻	eof
鲥	rkd
彳	oia
耜	cxx
刳	gbk
倮	nkf
椟	feg
疬	tgy
疃	ksb
罟	lej
偾	nel
屙	xyj
绋	zyn
饔	szo
萘	egb
痿	tmz
踬	jpl
缳	zlr
伲	nxr
怛	uka
菀	ewy
枋	fsy
喆	bjj
隈	ykh
糌	urk
崃	lbk
荛	ehg
疝	tll
绐	zzj
捽	dse
蘼	etk
猊	qnr
雩	fbz
踔	jie
憷	ufi
郫	nmy
廨	trm
钕	pzm
阝	yaa
绖	zhb
鲢	rwh
蛴	isn
氚	mnd
悛	uzr
眚	mcl
枧	flr
圯	byy
聬	coy
榘	mhf
鲵	rnr
舻	pix
艉	pxm
堍	brs
卺	xky
鲭	rcq
衄	mle
谘	stj
兕	iyr
糸	zaa
檩	fsb
瞢	ell
徭	opl
枨	fch
耪	css
跗	jnd
郇	rky
殂	alc
噻	jwb
翛	niy
蟥	ieo
鲷	rlj
胙	qmi
吽	jmb
崐	lkr
谮	shk
粝	ugy
恝	cyw
瞵	luh
苡	ezo
炅	kuo
髹	cpf
觫	rlj
枵	fjz
嬲	kyy
悰	uwb
胝	qrs
涑	vfj
瘿	tlz
唼	jsz
崟	llp
谖	spx
黥	lbk
陔	yso
筲	mkq
嗌	jul
慝	hew
龆	iyj
矅	lyn
戽	wte
谇	sse
妣	zhr
铖	phy
饩	omy
郾	hky
襞	xjs
秾	mwr
踣	jsj
甏	bjs
蕈	efe
汆	okv
搛	dux
楗	fyb
秕	mhr
磻	gpk
逯	wxk
髁	lkf
瓘	cen
龀	irr
旆	sml
恧	gwz
睏	ljf
犸	qmx
桫	fvm
鸺	nfr
鍪	xmp
胗	qop
貊	pan
薤	eaa
裼	wko
娈	szm
锞	pkf
滉	vkg
蛱	ibu
簋	mxl
笕	mlr
篚	mhk
揸	dfa
疔	tai
亶	sja
铯	pry
珰	ckx
浼	vrr
祆	wmg
俜	nkz
蛞	imi
歃	mnr
曛	kmv
鞳	eej
芎	eyz
燊	uuf
饣	oxa
箜	mwb
酹	fpd
獬	qrm
嵝	luz
龅	iry
糁	uzp
刿	lrk
鬯	osr
篌	mnm
聱	cyc
芡	ero
缌	zkw
茆	ery
邠	oyy
钍	pbv
蓐	egd
硗	ghg
埝	bow
猹	qfa
湔	vuk
墁	bkx
俣	njg
皦	nnm
鲅	rgs
跬	jbb
蓱	eve
柽	fxb
蹁	jwl
棗	fll
贶	ljr
垧	bnj
堋	bqq
粢	tru
芄	eqs
戋	hma
祧	wrv
莩	epy
硎	gak
镔	pwo
艋	pyl
钽	pka
汔	vmy
缍	zmb
讠	saa
觏	ell
菘	efz
儇	nlr
藿	efn
籴	ouf
猁	qmk
鳐	rpl
窭	wuz
阌	tpx
畛	kop
鹇	tfr
愔	usk
猞	qom
纮	zgz
鲞	ubr
浯	vbj
葑	ebd
崤	loq
芫	ebr
跽	jyw
襻	wfm
顸	aeg
鹣	uxr
袷	woj
綮	wmz
艏	pun
溽	vgd
菪	ewg
羟	uxb
珧	crv
禇	wbm
鲽	ref
亓	bnd
胼	que
旰	kae
褰	wes
蚍	ihr
尥	grs
侔	nzm
黼	kkf
胩	qii
窬	wok
鹆	oor
瘳	typ
蠼	ilx
衤	wta
髌	lwo
泺	vrk
闫	tcd
遘	web
瘥	tub
甙	heb
鄄	fby
蔸	err
唪	jcb
胨	qhk
蕞	ekx
蕻	eco
檗	xjf
璩	cig
瞍	lnx
鲎	vwr
洇	vjd
鬲	ajl
幪	leg
皲	whx
傺	nrb
锸	pmn
淠	vkn
詠	swv
蜾	ikf
澐	vfz
氽	okv
鲶	row
锼	pnx
搌	dxh
薅	ezd
茛	exo
夼	gnd
炱	zju
嶝	lxu
袢	wub
朊	qbr
晡	kfb
撙	dud
皝	ncg
喾	vwj
豇	ajb
岣	lrj
坫	bij
馇	ofa
黹	kkl
虼	imy
忭	usi
贳	ezl
霪	fvb
蛲	ihg
蝥	xmi
摅	diw
迕	wme
礅	gsm
垡	nhb
澔	vnj
坩	beb
骟	xwy
萏	ern
趼	jae
茑	erz
轹	hrk
眭	lbb
芑	eyy
忮	uex
陧	ykb
煳	ueq
炆	uso
硖	gbu
鄣	sky
垤	bhb
彿	oyn
昴	kry
玥	cqv
鞒	emn
莨	esx
炁	hrv
蟛	ibp
獍	qsr
舡	pbi
蚧	ion
苁	eoo
苘	eld
昃	kgo
甍	els
貔	pnr
蚺	ilb
镓	pwg
埕	bjc
筇	mby
擐	dlr
砟	gmi
囟	nos
洧	vgq
揠	dhz
哚	jqf
谫	suy
嗪	jcm
崦	lgz
锆	pmj
褔	wak
裉	wxo
醵	fig
畎	kgs
隹	nia
毳	mmm
矧	myi
窆	wmw
蛑	izm
碁	ecg
颟	efg
钣	ppx
庹	tes
熘	urk
闶	tsq
潲	vmq
蝓	iok
幞	lku
艚	pek
镄	pyl
萑	eni
渖	vwk
硭	ges
塄	bls
哕	jlr
驵	xlc
戥	kmh
栲	fbz
苤	ega
洳	vzj
犴	qae
醅	fsj
厍	ghe
胍	qps
堙	bfb
嵛	lok
裒	snb
躐	jzz
檠	erf
舴	pmi
呋	jbo
礻	wsa
嗉	jcz
铗	pbu
螈	igk
坌	oyb
邴	foy
缵	zml
呒	jag
辋	hld
蚵	iaj
痤	tob
蜩	ilj
绱	zkl
瑭	ctj
舳	pki
鲔	rgq
浍	voz
瘼	teg
嗞	juz
岢	laj
呤	jow
裣	wov
诶	szm
鸸	grz
腠	qcg
肟	qbz
氘	mnd
殪	abu
吣	jwz
荽	epz
瓿	sjs
鹨	yyr
莸	eqg
廾	eaa
柒	vhf
嘧	jwl
爝	upd
蝾	ief
癔	tsw
狃	qxe
铌	pxr
鹋	ekr
酐	fae
鳇	rnc
葜	ecg
貅	pnf
谂	sow
锛	pge
笱	mrj
碡	gcz
疳	teb
羝	urs
跏	jyj
钋	pid
鳔	rfb
搥	dwx
耨	cgd
颞	cxg
矬	mob
橥	qbf
劼	bjy
黟	lbr
耧	cuz
虮	iqd
谳	ses
溲	vnx
哌	jpr
痖	tak
榱	fsk
胂	qki
牤	msh
锬	puu
旻	kso
栳	fbr
啉	jff
甓	xjs
貘	peg
滏	vou
蝤	iuf
髟	cpd
鲦	rrf
鞔	err
鲐	rzj
颃	sqg
埤	bne
鲆	rau
铊	pwr
糇	unm
栝	fmi
蓣	exg
酃	fjy
埸	bko
赙	lfd
澶	vsa
酾	fal
冫	tda
碲	gsl
倕	nmb
丌	and
廑	tec
绨	zuy
觜	irl
菬	evj
阽	yij
劓	nkk
瘵	trb
菔	eqx
倵	nai
橼	fzg
匚	haa
缂	zee
悝	ukb
芴	ero
鼯	nzj
倬	nie
钌	pyv
厣	ggk
椐	fxj
锔	pxj
锕	pyj
冁	ukh
艨	peg
鲡	ral
酤	fej
绲	zkr
埏	byi
瀹	vol
溱	vcm
砩	gyn
枘	flo
舾	pfj
瘖	tsk
黉	vwo
蛘	iuc
岍	lae
鲻	rzk
荭	ezb
邶	thy
獚	qeo
埚	bjo
蒉	ejl
嫘	zkz
骒	xkf
攮	der
挢	dmn
噍	jnv
孓	ysv
螽	rti
尢	gra
榍	fxq
瑱	ceo
呯	jau
柁	fwr
瘐	tno
崞	lsy
臌	qbx
狨	qhg
笮	mmi
苊	egy
豳	ggl
夂	rsa
庀	trr
喹	jgb
栌	fix
鸲	rjr
穸	wrs
髂	lwj
酲	fjc
磙	gsz
狴	qhb
堠	bnm
芩	eox
嫜	zse
嵫	luz
鲳	rkk
謦	bxs
甾	zzk
绠	zao
艟	psb
嗍	juq
铒	pce
脬	qpy
溏	vtj
仳	nhr
骱	lon
沩	vus
巿	ali
檎	foz
岵	lej
鞴	eel
槔	fne
赆	lxt
涠	vjy
璺	nbs
鞲	eeb
缡	zsz
镆	peg
杩	fxv
狁	qzr
澺	vsw
跞	jrk
墼	bkb
蚴	izy
獯	qmv
瘙	txi
焓	uoj
剀	lyk
垌	bld
氙	mll
敉	umo
肷	qro
啶	jwd
纩	ztg
稃	mpy
辁	hoc
锾	ppx
嚇	jbo
苄	esi
篥	mff
丨	iaa
擗	dxs
蔌	efr
硪	gms
缋	zjl
坭	bxr
蘩	emz
樘	fkb
萜	elj
鹾	ijb
桤	fly
炻	uog
泖	vry
蝰	igb
罨	lgz
钇	pyd
氩	mak
镟	psi
廒	tcm
卣	ijx
蹯	jpk
勍	sky
螬	iek
醭	fku
箅	mkn
砜	gqo
蓰	eoi
箦	mcl
崾	lfz
莶	eov
湓	vol
骺	lpj
鄹	cxy
皜	nsj
艽	eqy
洫	vml
脒	quf
砘	ghz
脲	qxk
铓	pes
钐	ppd
脞	qob
泶	vwk
呙	jlo
凵	zia
茇	egs
龠	oal
冇	gld
螗	itj
疰	tsc
糈	uxq
脘	qwr
蚰	iki
蝻	iel
癀	teo
躔	jtb
岈	lhi
糨	uyi
铍	pxi
彡	pda
肭	qlo
瘛	tcw
屌	xjl
鲣	rkb
冂	lda
冖	wwa
瘌	tfk
罱	lel
鳊	rwl
潾	vuh
轵	hjo
僬	nnv
哳	jdp
旛	smk
蟪	ifw
濞	vnn
芈	iab
绗	zoi
毹	oam
镅	pxl
丶	saa
酎	fds
埘	bkd
蛸	ikq
腧	qok
迮	wmi
颥	fgg
桄	fkg
氍	llm
蕹	esn
圬	bbz
锓	pxx
鼷	nzg
鹱	rex
稆	mjj
忉	uyd
蓠	esz
铷	pzj
敫	nsm
眵	lrr
捃	dxj
吔	jyi
麴	fou
骶	lrs
蒌	euz
砗	ghe
庳	tne
铫	prv
膦	quh
缲	zjf
硇	gno
钶	paj
妺	zaf
铈	psl
铕	pgq
肼	qbn
钪	psq
筢	mdy
咴	jgu
芏	ebv
狳	qom
坶	bzy
垲	bly
痦	tbj
馘	una
煺	uwx
唛	jcr
舯	pji
浞	vji
袼	wrj
萆	ene
嘌	jfb
蛏	ixb
鲩	rwr
仂	nym
羧	uzr
鲮	rbr
郐	oby
蔟	esm
掎	dgj
砹	geo
婛	zsk
鲰	rcx
躜	jml
锪	prw
锎	pte
悃	ujf
轺	hyj
稂	msx
舭	phr
锍	psn
酴	fom
醣	ftj
茼	eld
舣	pso
鹎	nmr
煸	uwl
痄	tmi
肜	qpd
胬	zxo
氇	mrk
氆	muk
眍	lho
篼	mrr
鳙	rtq
剞	gak
眢	ryl
崁	lbr
镲	pwb
薷	efg
乇	mhd
渫	vef
捨	dom
滠	vcx
窀	whz
缏	zno
铟	pjd
芤	eyz
攵	moa
霙	feg
揲	def
礓	gck
滗	vmm
檫	fwb
钔	ptl
溻	vky
氪	mer
粞	ufj
钭	pte
锘	pej
镱	psw
钫	psy
艴	yny
酞	fgs
灬	vaa
锊	ppd
洚	vrh
镦	psm
刭	xbk
铪	poj
怊	uyj
踺	jyb
疒	taa
牿	mmj
茈	eir
镘	pkx
埯	bgz
坜	bgy
漭	vee
砬	gsu
銎	bqp
蒽	ejw
腩	qel
吲	jyi
鬏	cpu
圊	jcq
犰	qqy
瘕	txx
锫	psj
烀	umu
铞	pjl
筘	mdj
觖	rlg
黪	lbp
鐾	xjp
箢	mwy
帱	lcd
苠	eyh
犋	mlo
菥	efp
鳘	mzr
劂	guk
酏	fyi
岽	lhk
虍	iha
宀	wda
镧	ptl
珝	cyy
蜱	ine
嚆	jes
揞	dsk
瘅	tue
锇	pms
锿	psj
簖	mzp
磉	gxf
镙	pkz
鼢	nzy
嬤	ztz
阢	ygr
吖	jui
桊	ubf
鳆	rmr
醑	fxq
钸	pgl
陴	yne
铽	phw
鲼	rel
锖	pcq
膪	qsj
掭	dau
镡	pfe
铼	pbk
荬	exg
耱	ctg
犏	mwl
瑄	cwk
瑢	cwj
癃	tym
瓞	pmo
冱	tbz
铘	phy
赇	lds
筻	mao
蕺	ejs
钬	puo
癍	tcc
筅	mmr
檑	ffk
憝	syw
瘊	tnm
猃	qov
鳢	rku
屮	zia
螋	inx
莰	ebr
佴	nce
蜞	iec
瀵	vuo
哿	yjj
蒴	euq
铑	pbr
葶	esa
帥	mxl
胲	qso
醌	fkr
榀	fjj
蝽	ico
铥	pmz
礤	geb
璁	cnw
丬	tia
耩	ceb
苈	egy
巯	xbn
蔹	eom
齄	nka
蟓	irg
镥	prk
飑	qoy
蒎	evr
勝	quy
茳	evb
丿	maa
耖	ckm
钆	pzv
耔	cya
牮	nhm
铹	pey
镨	puk
莛	eyb
膣	qwh
茚	ery
戤	ymh
搋	dpq
卩	yaa
虓	qiq
痃	tsz
鲕	rgl
肀	xba
澉	vxm
屄	xwo
鲴	rjj
茺	esr
羰	ulu
耵	cai
耠	coj
螵	ifb
镤	pku
耥	ckl
镩	pwi
彐	xba
镎	pom
瘭	tfb
鄭	ufy
柃	fow
聍	cwa
亠	saa
瘃	tgs
勹	rya
沲	vmy
攉	dfn
楱	fcg
碹	gwk
腽	qkl
塥	bal
鹛	xlr
葙	efl
禚	wuv
锝	pkd
弪	yxb
劐	enk
鼽	nkq
鳋	rxi
骣	xxy
浈	vil
碥	gwl
脎	qof
軎	bkj
钷	phj
猸	qxl
撖	dxm
鲒	rbj
鲚	rsn
蒇	ehl
毪	mzm
漤	vfz
攴	ixs
赕	luu
佧	nii
耢	cey
蒈	ehn
荮	ezd
礞	geg
轷	hmu
尜	kgk
氕	mym
铴	pvo
脶	qjo
腙	qwb
鳓	rey
鲺	ryi
巛	zzz
彧	hjp
歷	gmi
囍	bjj
塅	bnq
圡	bsv
珷	cai
玨	ccv
珡	cco
璟	ckk
瞭	lgk
瞓	lsn
潽	vuk
昇	kme
咁	jeb
哋	jby
啩	jbi
啫	jbm
嘢	jkx
〇	jaa
嚟	jmk
唸	jow
喺	jnz
跶	jwg
翀	yyi
祎	wby
焗	uxj
冧	wff
窸	wpw
抔	dgi
撚	drv
椪	fuk
娬	zai
娒	zmz
佢	nhx
郃	oay
彣	spd
囧	jol
犇	mmm
乂	osa
夬	xgd
匜	hyi
玕	cae
抃	dsi
芼	emh
沚	vii
沨	vqo
纴	zmb
玠	con
玦	cxg
茓	ewo
茀	eyn
杻	fxe
昉	ksy
炘	upd
垱	bkx
挦	dxd
剋	ejk
柈	fub
眊	lmh
饹	orj
疭	too
竑	sgz
闿	tly
羑	urs
浕	vxt
恓	ufj
牁	zgj
琤	crx
栟	fue
鸮	jar
俵	ncr
俶	nix
訚	tls
浥	vjy
牂	zgu
骎	xxx
琇	cmm
捯	dhk
埵	bmb
梿	fwh
棁	fur
崚	lbr
鸻	orz
馃	okf
阇	tbm
欸	zmr
琫	ccb
琯	cwx
揳	dcg
靰	egr
靸	eys
雱	fsy
睄	lkq
嵖	lfa
嵎	lkz
铻	pbj
媭	pgz
鲀	rhz
颎	rug
焜	ukr
湲	vpx
湉	vum
翚	yyh
楯	fpl
跐	jir
鹐	rnr
瘆	tzp
滫	vnq
滃	voy
滪	vxg
叆	bzx
榖	bwq
靺	eaf
僰	flo
豨	gol
嘡	jkb
魆	nhm
粿	ukf
熥	uwl
奭	gan
鋆	brp
踒	jmz
潟	vnv
褟	wky
璠	cpk
璘	cuh
縠	bwq
螠	iul
镚	plq
镠	pyp
獴	qeg
赟	sal
澥	vrm
璪	cjf
鞬	eyb
罽	lgk
鞨	ekr
鞧	euf
藠	enn
蹽	jgk
蹾	jsm
齁	nkj
镴	pzz
臜	qml
齉	nkr
卬	rhy
圢	bai
伋	nys
冮	tbi
氿	vqy
汈	vya
氾	vyy
讱	sys
扞	dae
圲	bme
圫	bmh
芃	eqs
朸	fym
邨	hzy
屾	lll
辿	wll
伣	nlr
癿	nkz
汋	vrs
讻	soz
玓	crs
玘	cyy
玚	cyo
坉	bhz
扽	dhz
坋	boy
扺	drh
毐	bzg
芣	egi
苉	ehr
芠	eso
杙	fhs
杄	fme
杧	fsh
尪	grc
坒	hrb
旴	kad
岠	lhx
冏	lda
觃	lya
伾	nga
伭	nsz
佖	nwm
佁	nzj
飏	qoo
汫	vbn
沘	vhr
汭	vlo
沇	vzr
忳	uhz
祃	wsx
诇	sld
邲	wmy
诐	sxi
屃	xlo
岊	yll
妧	zbr
妘	zbz
驲	xkv
纻	zwa
玤	cci
玞	cbo
玱	coy
邽	bby
邿	bdy
坥	blc
坰	bld
坬	bps
坽	bow
弆	bze
茋	ers
苧	ewa
苾	ewm
枅	fae
枍	foz
矻	gmy
匼	hoj
旿	kme
昄	kpx
咉	jlg
咇	jwm
咍	jzj
岞	lmi
峂	lrt
囷	jmf
钖	pyo
牥	msy
垈	nhb
侁	nmr
佺	noc
侂	nth
佽	ntr
侘	nwh
郈	pay
舠	pyd
攽	oym
肸	qoe
狉	qga
饳	ozz
炌	uon
泜	vrs
祋	wqx
祊	wsy
弢	yzx
陑	ygl
陎	ymk
乸	yzy
妭	zgs
姈	zow
叕	xxx
玶	cau
珇	clc
珅	cki
珌	cwm
玿	cyj
韨	bys
垚	bbb
垯	bwg
垙	bkg
垍	bnl
耇	brj
垎	brj
垟	buc
垞	bwh
垏	bxb
荖	ebr
荁	ebk
荙	ewg
茽	eni
荄	eso
荓	eue
柷	fjr
柊	frt
枹	fry
栐	fwv
柖	fyj
郚	bxy
砆	gbo
砄	gxg
耏	gpd
奓	grr
昺	kfo
昽	kgm
盷	lrt
咡	jce
咺	jbk
昣	kop
昤	kow
昫	krj
昡	ksz
咥	jhb
昪	kze
虷	iae
哃	jld
峘	lbk
耑	lgl
峗	lry
峧	lso
帡	lue
钘	pae
俙	nol
俍	nsx
垕	pab
衎	oae
弇	oae
鸧	oyr
胠	qbz
胈	qgs
胣	qmy
朏	qzz
飐	qoj
訄	qys
饻	osr
庤	tbd
疢	tuo
炣	uaj
炟	uka
洭	vhc
洓	vfl
浉	vkl
洸	vkg
洑	vns
洢	vnx
洈	vry
洨	vso
洴	vue
洣	vuf
恔	uso
宬	why
扂	wij
袆	wby
祏	wsg
祕	wwm
叚	xbx
陞	ymb
娀	zhg
姞	zbj
姱	zgz
姤	zpj
枲	zjf
骃	xjd
骉	xxx
珛	cgq
玼	cir
珖	ckg
珽	cyb
珫	csr
珢	cxo
珕	cyy
垾	bke
垺	bpy
埆	brl
垿	btx
埌	bsx
埇	bxl
茝	ehv
鄀	egy
莝	eob
莙	exj
栻	fhb
梠	fjj
栴	fms
梴	fyi
栒	frk
砵	gfa
砠	glc
砫	gsc
硁	gxb
翃	gzy
郪	axy
辀	hpy
哢	jce
晊	khb
唝	jbl
哱	jey
冔	kjd
晐	kso
畖	kps
蚄	isy
蚆	iyi
峿	lbj
崄	lov
帨	lur
崀	lsx
甡	mmc
倻	ncy
倴	nge
倞	nsk
倓	nuu
倧	nwb
虒	piq
舥	pyi
鸰	owr
朓	qrv
鱽	ryd
峱	qxl
竘	srj
羖	uqx
羓	uyi
烠	ugq
烔	uld
烶	uyb
烻	uyi
涍	vby
浡	vey
涄	vkz
涐	vms
浰	vmk
浲	vrc
悈	uhe
悢	usx
宧	wdh
窅	wol
窊	wps
窎	wrz
扆	wsr
袪	wbz
袗	wop
堲	xyb
烝	xkv
砮	zxg
翂	yyy
剟	xxk
骍	xse
琎	cwn
珸	cbj
珵	cjc
琄	cjq
琈	cpy
琀	coj
堐	bgb
埼	bgj
堌	bjj
掞	duu
埪	bwb
勚	ezy
菂	ens
菍	eow
菼	euu
萣	ewd
菉	exk
梼	fcd
梽	fbw
桲	fey
梾	fbk
桯	fjc
梣	flx
梌	fom
敔	bxm
硔	geo
硙	gly
硚	gmn
硊	gry
硍	gxo
龁	imy
逴	wie
翈	kyy
晙	kzr
畤	kbd
蛃	ifo
蚲	iau
啴	jue
崒	lse
崌	lxj
铏	pak
铚	phb
笯	mzx
偰	ncg
偡	nez
偭	ngb
偲	nkw
偁	npb
鄅	miy
偓	nxh
徛	ogj
鸼	prz
悆	omw
鄃	oay
瓻	ogs
脟	qpd
鱾	ryy
猇	qiq
庼	thg
痓	thb
竫	srx
羕	uwv
焆	ujq
烺	usx
焌	uzr
淏	vkg
淟	vlo
淜	vqq
淴	vrw
淯	vsq
湴	vuk
涴	vwy
惛	urk
惔	uuu
惙	uxx
裈	wwh
祲	wxx
弸	yqq
弶	ysk
隃	yok
婞	zbu
娵	zcx
婼	zej
媖	zeg
婳	zaz
婌	zix
婫	zkr
婘	zuy
绹	zrl
絜	cyz
琲	ckc
琡	cix
琟	cni
琔	cwd
琭	cxk
堾	bco
堼	bbb
揕	dez
堧	bgg
堨	bkr
惎	ewz
萳	eel
鄚	eky
蓇	elw
萩	emu
蒐	enj
葰	enr
葎	eob
鄑	aky
葖	ews
蒄	ewd
棤	fek
棽	ffx
棫	fha
椓	fgs
椑	fne
鹀	bor
椆	flj
棓	fsj
棪	fuu
椀	fwy
酦	fzs
奡	ann
皕	ann
詟	gms
辌	hsk
棐	kcf
龂	ipd
牚	kjh
睎	lol
晫	kie
晪	klo
晱	kuu
畯	kzr
斝	jje
喤	jnc
崶	lbd
嵁	lez
嵅	lhj
崿	ljz
嵚	lpr
翙	lry
圌	jlg
圐	jls
赑	lll
赒	llj
颋	ymg
稌	mom
筜	mkx
筥	mjj
傃	ncz
傉	ngd
傒	npg
畬	omk
脿	qcr
腘	qjs
腒	qxj
鲃	ryi
猰	qcg
猯	qlg
馉	olw
鄗	sjy
廆	tnj
鄌	txy
遆	wsl
旐	smv
焞	usy
溚	vej
溁	vef
湝	vhn
渰	voe
渟	vsa
溠	vub
渼	vug
湣	vyk
湑	vxq
愐	ugb
愃	uwk
敩	vwm
棨	wmf
扊	wuu
祼	wkf
婻	zel
媆	zgg
媞	zmk
媓	znc
媂	zsl
媄	zug
缊	zkl
缐	znk
瑃	cco
瑓	cfl
瑆	ckm
瑖	cnq
瑝	cnc
瑔	cnk
瑀	cml
瑳	cub
瑂	cxl
嶅	cyl
瑑	czg
髢	cpy
堽	bli
赪	bnl
塝	bss
搒	dss
蒨	enq
蓏	epp
蓢	esq
蓂	ewo
蒻	eyt
楪	fef
榃	ffk
榅	fkl
楒	fkw
楩	fno
椸	fsy
楙	fxf
歅	fbr
碃	gcq
碏	gek
碈	grk
硿	gwb
鄠	fby
辒	hkl
暕	kfl
鹍	khr
暅	kuk
跱	jbd
蜐	iby
蜎	ijq
嵲	lnf
锳	peg
锧	ppl
稙	mel
筼	mjl
筶	mmj
筦	mwr
筤	msx
僇	nyp
艅	pom
貆	pbk
腨	qlg
腯	qpl
鲉	rki
鲌	rnk
鲏	rxi
雊	rjn
猺	qpl
飔	qow
觟	rlb
馌	obl
裛	sjy
鄘	txy
鹒	txr
鄜	txy
麀	txr
阘	tky
煁	uez
煃	ugb
煴	ukl
煋	ukm
煓	ulg
溍	vak
溹	vez
溦	vlm
溵	vpq
漷	vsy
滘	vwj
滍	vzi
慥	uwj
慆	upn
禋	wfb
禔	wsk
禘	wsl
禒	wzg
鹔	xnr
嫄	zgk
勠	yyy
戣	xah
耤	cek
瑨	cak
斠	ele
摏	dcn
墈	bey
墐	bec
墘	bey
摴	dfz
靽	eub
鞁	exi
蔈	efb
蔊	eue
榰	fbk
榑	ffd
槚	ffl
槜	fnm
疐	ewi
碶	gcg
碨	gkh
鹖	krr
嶍	lyn
锽	pnc
镃	puz
馝	mkm
箖	mff
劄	mok
僔	nud
僎	nyo
鲗	rlk
鲘	rpj
夐	rlr
飗	qok
凘	tep
廙	tko
鲝	ucr
熇	usj
漖	vbm
潩	vko
漼	vln
漴	vlb
漈	vrb
漋	vym
漻	vyp
慬	uec
褕	wok
禛	weo
隩	yng
嫕	zhw
嫭	ziu
麹	cru
璆	cyp
漦	bkk
叇	bzk
墣	bku
墦	bpk
墡	buj
薁	eng
蕰	evl
蔃	eyi
鼒	dmx
磏	gux
殣	aec
慭	bkw
霅	fvs
暵	keo
暲	kse
暶	ksi
踦	jgj
蝘	ihz
蝲	ifk
噇	jsb
噀	jyo
罶	lrk
嶲	lny
嶓	lpk
嶟	lud
嶒	luk
镈	pfd
镋	pkr
皞	nne
皛	nnn
艎	pnc
鹟	ozr
鲪	rxj
鲬	rxl
觭	rlj
鹠	rsr
鹢	uor
熛	ufb
潖	vcy
潵	vem
澛	vrk
潏	vxl
憭	ugk
憕	uxu
戭	wah
褯	wtl
嫽	zgk
璥	cem
璲	cwg
璒	cxu
憙	bjw
薳	ewr
黇	ekj
蕗	ejj
薢	erm
橞	ffw
橑	fgk
橦	fsb
觱	hal
磡	gey
磜	grb
豮	gel
虤	iqq
曌	kqb
曈	ksb
疁	kyp
嶦	lrs
馞	mky
穄	mrb
篯	mph
簉	mwj
衠	oeo
螣	qui
縢	quz
鲯	rec
鲹	rzp
亸	sye
羱	ugk
糒	uel
熻	uoy
燚	uuu
燏	uxl
濩	vex
濋	vfi
澪	vfw
澴	vlr
澼	vxs
憺	urs
翯	yys
璬	cnm
髽	cpb
擿	dwl
薿	eri
薸	evb
櫆	fne
檞	frm
繄	hmz
磹	gfe
瞫	lfe
蹐	jvq
蟏	ieo
矰	muk
穙	mku
穜	msb
簕	mey
簃	mmr
儦	ntv
魋	nni
斶	pli
谿	pzj
鲾	rak
鳁	rkl
鳂	rkh
鳈	rnk
鳉	rtd
襕	wtl
襚	wwg
螱	xbi
嬬	zfg
嬥	zyn
瓀	cfg
鬶	bol
爇	ebv
鞮	eek
藟	ekk
藦	etm
藨	etv
鹲	ewr
黡	ggv
礌	gfk
蹢	jsl
蹜	jwn
蟫	ife
嚚	jjj
髃	lkz
镮	plr
酂	mry
馧	mkl
簠	mfl
簰	mne
鼫	nzg
鼩	nzj
臑	qfg
鳒	rux
鹯	sjr
癗	tfk
翷	ury
瀔	vbq
瀍	vtb
瀌	vtv
襜	wrs
嚭	bjj
蠋	ili
翾	lay
儳	nrs
鳚	rxd
鳛	ryn
麑	txr
麖	txk
彟	xdx
嬿	zev
鬒	cpo
蘘	ese
欂	fed
甗	ias
巇	lih
酅	lny
髎	lyp
犨	nnm
爔	uus
瀱	vlk
襫	wgn
孅	zoa
骦	xfl
耰	car
瓖	cse
鬘	cpx
罍	kkl
鼱	nzq
鳠	rex
鳡	rhw
鳣	rsa
爚	uol
灈	vln
韂	ers
糵	emu
皭	npd
龢	oam
鳤	rmx
亹	snl
玃	qlx
醾	ftu
齇	nkl
	eaa
	gda
旡	hra
冋	lda
岡	lda
罒	lka
⺮	maa
	maa
⺁	pda
匃	rya
	uaa
丷	uda
⼹	xba
	xsa
	yaa
㇋	yaa
⺄	yaa
⺋	yya
乚	zaa
丩	zia
嚗	jkk
鈭	irp
摰	bom
砲	gry
隡	ysm
霂	fvf
蝏	isa
摨	dxm
祂	wyi
裡	wkb
咘	jgl
籓	mvk
濬	vil
暱	khj
撠	deh
瘜	tnw
華	eab
嬅	zeb
咗	jgb
鮨	rrk
霑	fvj
舺	pki
叒	xxx
歳	ihk
箛	myp
菓	ekf
孖	yya
苳	ert
敹	iwm
蔘	ezp
睺	lnm
薙	emn
卐	zaa
卍	yii
阯	yii
暠	ksj
肏	olo
梶	fxm
惢	www
𰻝	www
	coa
耂	bma
⺩	caa
龶	cia
龺	eea
朩	faa
覀	fja
丆	gaa
乑	gqa
㐄	hia
亅	iaa
	jia
⺌	koa
	kwa
牜	mba
⺧	mba
	mda
爫	pva
⺈	raa
	uba
⺷	uca
⺶	uca
丅	aia
乛	xaa
戉	hma
嘚	jod
巭	byo
嫑	gfz
劇	igk
隊	yug
谞	sxq
嫪	zyp
為	uxv
劉	rsk
幹	eoe
毬	mds
掱	mmm
數	jem
嘂	jjj
圙	job
兲	cov
忈	bwz
烎	aeu
尛	kkk
怹	nyw
姦	zzz
恏	zyw
颪	aii
槑	jff
嘦	joz
儁	nny
勥	yjy
瞐	lll
羴	uuu
鱻	rrr
氼	kod
猋	gss
畊	kbn
一个	a'
工作	b'
现在	c'
大家	d'
世界	e'
需要	f'
不是	g'
成为	h'
上海	i'
中国	j'
时间	k'
同时	l'
我们	m'
自己	n'
公司	o'
所以	p'
服务	q'
比较	r'
就是	s'
问题	t'
情况	u'
没有	v'
这个	w'
对于	x'
已经	y'
发展	z'
一个	a/
工作	b/
现在	c/
大家	d/
世界	e/
需要	f/
不是	g/
成为	h/
上海	i/
中国	j/
时间	k/
同时	l/
我们	m/
自己	n/
公司	o/
所以	p/
服务	q/
比较	r/
就是	s/
问题	t/
情况	u/
没有	v/
这个	w/
对于	x/
已经	y/
发展	z/
谢谢	ss'
哈哈	jj'
